
LIBOR SZTEMON'S CZECH-PERSIAN WORD LIST

20. únor - 20. bøezen	Espand
21. bøezen - 20. duben	Farvardin
21. duben - 21. kvìten	Ordibehešt
21. leden - 19. únor	Bahman
22. kvìten - 21. èerven	Xordâd
22. listopad - 21. prosinec	Âzar
22. prosinec - 20. leden	Dey
23. èervenec - 22. srpen	Amordâd
23. øíjen - 21. listopad	Âbân
23. srpen - 22. záøí	Šahrivar
a	va, o
abeceda	alefbâ
adresa	âdres, nešâni
adresáø	daftar e nešâni
Afghánistán	Afqânestân
ahoj	salâm, dorud
ach!	âh!
akreditiv	e'tebârnâme
aksamit	maxmali
Albánie	Âlbâni
album	âlbum
ale	joz, vali
alej	kuceh
alergie	âleri
alibi	bahâne
almanach	sâlnâme
alpskı	Âlpi
Alpy	kuhhâ ye Âlp
Amerika	Emrikâ
ametyst	yâqut e români
ananas	ânânâs
anèovièka	mâhi ye kuli
andìl	faravahr, ferešte
anekdota	šuxi
angína	barâmadegi ye lowze
anglickı	engelisi
angrešt	angur e farangi
ani	hati, hic
ano	âri, bale, âre
antibiotickı	ântibiyotik
antibiotikum	ântibiyotik
antickı	atiqe
antikoncepce	dâru ye zedd e âbestani
antiseptickı	zedd e ofuni
apartmá	šabestân
apendix	âpândis
aperitiv	pišpâre
aplaudovat	sotudan, âfarin goftan, kaf zadan
Arab	Arab
Arabové	Arâb
arabskı	arabi
aranovat	cidan
Argentina	Arântin
arch	varaq
archeolog	bâstânšenâs
archeologie	bâstânšenâsi
architekt	âršitekt
archiv	âršiv
árijskı	âryâyi
armáda	lašgar, arteš, sepâh
aroma	bu ye xoš
artérie	šâhrag
artista	honarpiše
artritida	bâd e mafâsel
artróza	ârtroz
artyèok	ârtišo
asi	gerdâgerd, šâyad
aspirin	âsprin
astronom	setârešenâs
astronomie	setârešenâsi
a byl	bude bâš
a byl dìlán	karde šode bâšad
a byli	bude bâšand
a byli dìláni	karde šode bâšand
a dává	bedehad
a dávají	bedehand
a dával	dâde bâš
a dávali	dâde bâšand
a dávám	bedeham
a dáváme	bedehim
a dáváš	bedehi
a dáváte	bedehid
a dìlá	bekonad
a dìlají	bekonand
a dìlal	karde bâš
a dìlali	karde bâšand
a dìlám	bekonam
a dìláme	bekonim
a dìláš	bekoni
a dìláte	bekonid
a hraje	bâzi bekonad
a hrajeme	bâzi bekonim
a hraješ	bâzi bekoni
a hrajete	bâzi bekonid
a hraji	bâzi bekonam
a hrají	bâzi bekonand
a hrál	bâzi karde bâš
a hráli	bâzi karde bâšand
a chce	bexâhad
a chceme	bexâhim
a chceš	bexâhi
a chcete	bexâhid
a chci	bexâham
a chtìjí	bexâhand
a chtìl	xâste bâš
a chtìli	xâste bâšand
a jde	beravad
a jdeme	beravim
a jdeš	beravi
a jdete	beravid
a jdou	beravand
a jdu	beravam
a je	bâšad
a je dìlán	karde bešavad
a jedí	bexârand
a jedl	xorde bâš
a jedli	xorde bâšand
a jí	bexârad
a jím	bexâram
a jíme	bexârim
a jíš	bexâri
a jíte	bexârid
a jsem	bâšam
a jsem byl	bude bâšam
a jsem byl dìlán	karde šode bâšam
a jsem dával	dâde bâšam
a jsem dìlal	karde bâšam
a jsem dìlán	karde bešavam
a jsem hrál	bâzi karde bâšam
a jsem chtìl	xâste bâšam
a jsem jedl	xorde bâšam
a jsem lámal	šekaste bâšam
a jsem mìl	dâšte bâšam
a jsem nebyl	nabude bâšam
a jsem nebyl dìlán	karde šode nabâšam
a jsem nedával	nadâde bâšam
a jsem nedìlal	nakarde bâšam
a jsem nehrál	bâzi nakarde bâšam
a jsem nechtìl	naxâste bâšam
a jsem nejedl	naxorde bâšam
a jsem nepil	nayâšâmide bâšam
a jsem nepoèítal	našomorde bâšam
a jsem nepøinesl	nayâvarde bâšam
a jsem nepøišel	nayâmade bâšam
a jsem nespal	naxâbide bâšam
a jsem nevìdìl	nadâneste bâšam
a jsem nezavíral	nabaste bâšam
a jsem pil	âšâmide bâšam
a jsem poèítal	šomorde bâšam
a jsem pøinesl	âvarde bâšam
a jsem pøišel	âmade bâšam
a jsem øezal	borde bâšam
a jsem spal	xâbide bâšam
a jsem vìdìl	dâneste bâšam
a jsem zavíral	baste bâšam
a jsi	bâši
a jsi byl	bude bâši
a jsi byl dìlán	karde šode bâši
a jsi dával	dâde bâši
a jsi dìlal	karde bâši
a jsi dìlán	karde bešavi
a jsi hrál	bâzi karde bâši
a jsi chtìl	xâste bâši
a jsi jedl	xorde bâši
a jsi lámal	šekaste bâši
a jsi mìl	dâšte bâši
a jsi nebyl	nabude bâši
a jsi nebyl dìlán	karde šode nabâši
a jsi nedával	nadâde bâši
a jsi nedìlal	nakarde bâši
a jsi nehrál	bâzi nakarde bâši
a jsi nechtìl	naxâste bâši
a jsi nejedl	naxorde bâši
a jsi nepil	nayâšâmide bâši
a jsi nepoèítal	našomorde bâši
a jsi nepøinesl	nayâvarde bâši
a jsi nepøišel	nayâmade bâši
a jsi nespal	naxâbide bâši
a jsi nevìdìl	nadâneste bâši
a jsi nezavíral	nabaste bâši
a jsi pil	âšâmide bâši
a jsi poèítal	šomorde bâši
a jsi pøinesl	âvarde bâši
a jsi pøišel	âmade bâši
a jsi øezal	borde bâši
a jsi spal	xâbide bâši
a jsi vìdìl	dâneste bâši
a jsi zavíral	baste bâši
a jsme	bâšim
a jsme byli	bude bâšim
a jsme byli dìláni	karde šode bâšim
a jsme dávali	dâde bâšim
a jsme dìlali	karde bâšim
a jsme dìláni	karde bešavim
a jsme hráli	bâzi karde bâšim
a jsme chtìli	xâste bâšim
a jsme jedli	xorde bâšim
a jsme lámali	šekaste bâšim
a jsme mìli	dâšte bâšim
a jsme nebyli	nabude bâšim
a jsme nebyli dìláni	karde šode nabâšim
a jsme nedávali	nadâde bâšim
a jsme nedìlali	nakarde bâšim
a jsme nehráli	bâzi nakarde bâšim
a jsme nechtìli	naxâste bâšim
a jsme nejedli	naxorde bâšim
a jsme nepili	nayâšâmide bâšim
a jsme nepoèítali	našomorde bâšim
a jsme nepøinesli	nayâvarde bâšim
a jsme nepøišli	nayâmade bâšim
a jsme nespali	naxâbide bâšim
a jsme nevìdìli	nadâneste bâšim
a jsme nezavírali	nabaste bâšim
a jsme pili	âšâmide bâšim
a jsme poèítali	šomorde bâšim
a jsme pøinesli	âvarde bâšim
a jsme pøišli	âmade bâšim
a jsme øezali	borde bâšim
a jsme spali	xâbide bâšim
a jsme vìdìli	dâneste bâšim
a jsme zavírali	baste bâšim
a jsou	bâšand
a jsou dìláni	karde bešavand
a jste	bâšid
a jste byli	bude bâšid
a jste byli dìláni	karde šode bâšid
a jste dávali	dâde bâšid
a jste dìlali	karde bâšid
a jste dìláni	karde bešavid
a jste hráli	bâzi karde bâšid
a jste chtìli	xâste bâšid
a jste jedli	xorde bâšid
a jste lámali	šekaste bâšid
a jste mìli	dâšte bâšim, dâšte bâšid
a jste nebyli	nabude bâšid
a jste nebyli dìláni	karde šode nabâšid
a jste nedávali	nadâde bâšid
a jste nedìlali	nakarde bâšid
a jste nehráli	bâzi nakarde bâšid
a jste nechtìli	naxâste bâšid
a jste nejedli	naxorde bâšid
a jste nepili	nayâšâmide bâšid
a jste nepoèítali	našomorde bâšid
a jste nepøinesli	nayâvarde bâšid
a jste nepøišli	nayâmade bâšid
a jste nespali	naxâbide bâšid
a jste nevìdìli	nadâneste bâšid
a jste nezavírali	nabaste bâšid
a jste pili	âšâmide bâšid
a jste poèítali	šomorde bâšid
a jste pøinesli	âvarde bâšid
a jste pøišli	âmade bâšid
a jste øezali	borde bâšid
a jste spali	xâbide bâšid
a jste vìdìli	dâneste bâšid
a jste zavírali	baste bâšid
a lámal	šekaste bâš
a lámali	šekaste bâšand
a láme	bešekandad
a lámeme	bešekandim
a lámeš	bešekandi
a lámete	bešekandid
a lámou	bešekandand
a lámu	bešekandam
a mìl	dâšte bâš
a mìli	dâšte bâšand
a nebyl	nabude bâš
a nebyl dìlán	karde šode nabâšad
a nebyli	nabude bâšand
a nebyli dìláni	karde šode nabâšand
a nedává	nadehad
a nedávají	nadehand
a nedával	nadâde bâš
a nedávali	nadâde bâšand
a nedávám	nadeham
a nedáváme	nadehim
a nedáváš	nadehi
a nedáváte	nadehid
a nedìlá	nakonad
a nedìlají	nakonand
a nedìlal	nakarde bâš
a nedìlali	nakarde bâšand
a nedìlám	nakonam
a nedìláme	nakonim
a nedìláš	nakoni
a nedìláte	nakonid
a nehraje	bâzi nakonad
a nehrajeme	bâzi nakonim
a nehraješ	bâzi nakoni
a nehrajete	bâzi nakonid
a nehraji	bâzi nakonam
a nehrají	bâzi nakonand
a nehrál	bâzi nakarde bâš
a nehráli	bâzi nakarde bâšand
a nechce	naxâhad
a nechceme	naxâhim
a nechceš	naxâhi
a nechcete	naxâhid
a nechci	naxâham
a nechtìjí	naxâhand
a nechtìl	naxâste bâš
a nechtìli	naxâste bâšand
a nejedí	naxârand
a nejedl	naxorde bâš
a nejedli	naxorde bâšand
a nejí	naxârad
a nejím	naxâram
a nejíme	naxârim
a nejíš	naxâri
a nejíte	naxârid
a nejsem	nabâšam
a nejsem dìlán	karde našavam
a nejsi	nabâši
a nejsi dìlán	karde našavi
a nejsme	nabâšim
a nejsme dìláni	karde našavim
a nejsou	nabâšand
a nejsou dìláni	karde našavand
a nejste	nabâšid
a nejste dìláni	karde našavid
a není	nabâšad
a není dìlán	karde našavad
a nepije	nayâšâmad
a nepijeme	nayâšâmim
a nepiješ	nayâšâmi
a nepijete	nayâšâmid
a nepiji	nayâšâmam
a nepijí	nayâšâmand
a nepil	nayâšâmide bâš
a nepili	nayâšâmide bâšand
a nepoèítá	našomorad
a nepoèítají	našomorand
a nepoèítal	našomorde bâš
a nepoèítali	našomorde bâšand
a nepoèítám	našomoram
a nepoèítáme	našomorim
a nepoèítáš	našomori
a nepoèítáte	našomorid
a nepøicházejí	nayâyand
a nepøichází	nayâyam, nayâyad
a nepøicházíme	nayâ'im
a nepøicházíš	nayâ'i
a nepøicházíte	nayâ'id
a nepøinášejí	nayârand
a nepøináší	nayârad
a nepøináším	nayâram
a nepøinášíme	nayârim
a nepøinášíš	nayâri
a nepøinášíte	nayârid
a nepøinesl	nayâvarde bâš
a nepøinesli	nayâvarde bâšand
a nepøišel	nayâmade bâš
a nepøišli	nayâmade bâšand
a nespal	naxâbide bâš
a nespali	naxâbide bâšand
a nespí	naxâbad
a nespí (pl.)	naxâband
a nespím	naxâbam
a nespíme	naxâbim
a nespíš	naxâbi
a nespíte	naxâbid
a nevìdìl	nadâneste bâš
a nevìdìli	nadâneste bâšand
a nevìdí	nadânand
a neví	nadânad
a nevím	nadânam
a nevíme	nadânim
a nevíš	nadâni
a nevíte	nadânid
a nezavírá	nabandad
a nezavírají	nabandand
a nezavíral	nabaste bâš
a nezavírali	nabaste bâšand
a nezavírám	nabandam
a nezavíráme	nabandim
a nezavíráš	nabandi
a nezavíráte	nabandid
a pije	xâhad âšâmid
a pijeme	xâhim âšâmid
a piješ	xâhi âšâmid
a pijete	xâhid âšâmid
a piji	xâham âšâmid
a pijí	xâhand âšâmid
a pil	âšâmide bâš
a pili	âšâmide bâšand
a poèítá	bešomorad
a poèítají	bešomorand
a poèítal	šomorde bâš
a poèítali	šomorde bâšand
a poèítám	bešomoram
a poèítáme	bešomorim
a poèítáš	bešomori
a poèítáte	bešomorid
a pøicházejí	beâyand
a pøichází	beâyad
a pøicházím	beâyam
a pøicházíme	beâ'im
a pøicházíš	beâ'i
a pøicházíte	beâ'id
a pøinášejí	beârand
a pøináší	beârad
a pøináším	beâram
a pøinášíme	beârim
a pøinášíš	beâri
a pøinášíte	beârid
a pøinesl	âvarde bâš
a pøinesli	âvarde bâšand
a pøišel	âmade bâš
a pøišli	âmade bâšand
a øezá	bebarad
a øezají	bebarand
a øezal	borde bâš
a øezali	borde bâšand
a øezám	bebaram
a øezáme	bebarim
a øezáš	bebari
a øezáte	bebarid
a se stává	bešavad
a se stávají	bešavand
a se stávám	bešavam
a se stáváme	bešavim
a se stáváš	bešavi
a se stáváte	bešavid
a spal	xâbide bâš
a spali	xâbide bâšand
a spí	bexâbad
a spí (pl.)	bexâband
a spím	bexâbam
a spíme	bexâbim
a spíš	bexâbi
a spíte	bexâbid
a vìdìl	dâneste bâš
a vìdìli	dâneste bâšand
a vìdí	bedânand
a ví	bedânad
a vidí	bebinad
a vidí (pl.)	bebinand
a vidím	bebinam
a vidíme	bebinim
a vidíš	bebini
a vidíte	bebinid
a vím	bedânam
a víme	bedânim
a víš	bedâni
a víte	bedânid
a zavírá	bebandad
a zavírají	bebandand
a zavíral	baste bâš
a zavírali	baste bâšand
a zavírám	bebandam
a zavíráme	bebandim
a zavíráš	bebandi
a zavíráte	bebandid
atmosféra	atmosfer
atmosférickı	atmosferi
atom	atom
atomovı	atomi
auto	xodrow, mâšin
autobus	otobus
autokar	otokâr
automapa	naqše ye râhhâ
automobil	otomobil
avšak	joz, ammâ
a (do)	tâ
a do	tâ inke, tâ ânke
babièka	mâdarbozorg
bacil	bâsil
baèkora	dampâyi
baèkory	joft dampâyi
bájeènı	bâšokuhi
bajka	afsâne
baklaán	bâdenjân
baktérie	bâkteri
balet	bâle
balicí papír	kâqaz e kâdo
Balkán	Bâlkân
balkánskı	Bâlkâni
balkon	bâlkon
balon	bâlon
banán	mowz
banda	bând
banka	bânk
bankéø	bânkdâr
bankovní	bânki
bar	bâr
barevná tuka	qalam e naqqâši, qalam
barevnı	rangi, rangin
barevnı pøeliv	rangbar
barokní	bâroki
baroko	bârok
barva	rang
básníci	šo'arâ
bát se	tarsidan
baterie	bâtri
bavlna	panbe, katân
bazar	bâzâr
bazén	estaxr
bázlivı	tarsu
baant	qarqâvol
baina	siyâhâb, mordâb
bedna	sandoq
begonie	begoniyâ
bìhat	davidan
bìhem	darbeyn
belgickı	Beliki
Belgie	Belik
benzin	benzin
benzinová èerpací stanice	pomp e benzin
benzinová pumpa	pomp e benzin
ber	bebar
beránek	barre
beton	beton
bez	bi, bedun
bez-	bi-
bezbarvı	birang
bezbolestnı	bidard
bezcennı	bibahâ, biqeymat, biarzeš, nâciz
bezdìtnı	bibacce
bezdrátovı	bisim
bezejmennı	binâm, binešân
bezmotorovı	bimotor
bezpeènı	motmaen
bezpracnı	bizahmat
bezpráví	biqânun
bezprostøední	mostaqim
bezvıznamnı	biarzeš, bibahâ
bìec	davande
bìet	davidan
bicykl	docarxe
biè	tâziyâne
biftek	biftek
bilance	tarâz
bílé fazole	bâqelâ
bilion	biliyon
bílı	sefid
bláhovı	nâdân
blána	parde
blázen	divâne
blecha	kak
blikaè	cerâq e râhnamâ
blízko	nazdik
blízkı	bârik
bliší	nazdiktar
blud	zandegi
bobr	bidastar
bobtnat	âmâs kardan
bobule	dâne
boèní	pahluyi
bodlák	xâr
bohatır	pahlavân
bohosloví	xodâšenâsi
bohuel	moteassefâne
bojácnı	tarsu
bojkot	tahrim
bojkotovat	tahrim kardan
bojovat	jang kardan
bojovnı	jangi
bok	pahlu
bolení bøicha	šekamdard
bolest	dard, ranj
bolestivı	ranjâvar, dardâvar
bolševickı	bolševiki
bolševik	bolševik
bomba	bomb
borovice	kâj
bota	kafš
botanika	giyahâšenâsi
boty	joft kafš
bouda	kâšâne
brada	câne
bradavice	zegil
brambor	sib zamini
brambùrky	cips
brát	bordan
bratr	barâdar
bratranec	amuzâde, pesar-e-xâle, pesar-e-amme
brázda	šiyâr
brid (hra)	brij
broskev	šaftâlu, holu
brouk	susk
brıle	eynak
bryndáèek	pišband e bace, pišband e bacce
brzda	tormoz
brzy	zud
bøeh	sâhel
bøeh (moøe)	kenâr e daryâ
bøezen	mârs
bøicho	šekam, me'de
bøitva	tix, tiq
bude	xâhad bud
bude dìlán	karde xâhad šod
bude dìlat	xâhad kard
bude hrát	bâzi xâhad kard
bude chtít	xâhad xâst
bude jíst	xâhad xord
bude lámat	xâhad šekast
bude mít	xâhad dâšt
bude odpovídat	javâb xâhad dâd
bude pít	xâhad âšâmid
bude poèítat	xâhad šomord
bude øezat	xâhad bord
bude øíkat	xâhad goft
bude se ptát	xâhad porsid
bude se stávat	xâhad šod
bude slyšet	xâhad šenid
bude spát	xâhad xâbid
bude vìdìt	xâhad dânest
bude zavírat	xâhad bast
budeme	xâhim bud
budeme dìláni	karde xâhim šod
budeme dìlat	xâhim kard
budeme hrát	bâzi xâhim kard
budeme chtít	xâhim xâst
budeme jíst	xâhim xord
budeme lámat	xâhim šekast
budeme mít	xâhim dâšt
budeme odpovídat	javâb xâhim dâd
budeme pít	xâhim âšâmid
budeme poèítat	xâhim šomord
budeme øezat	xâhim bord
budeme øíkat	xâhim goft
budeme se ptát	xâhim porsid
budeme se stávat	xâhim šod
budeme slyšet	xâhim šenid
budeme spát	xâhim xâbid
budeme vìdìt	xâhim dânest
budeme zavírat	xâhim bast
budeš	xâhi bud
budeš dìlán	karde xâhi šod
budeš dìlat	xâhi kard
budeš hrát	bâzi xâhi kard
budeš chtít	xâhi xâst
budeš jíst	xâhi xord
budeš lámat	xâhi šekast
budeš mít	xâhi dâšt
budeš odpovídat	javâb xâhi dâd
budeš pít	xâhi âšâmid
budeš poèítat	xâhi šomord
budeš øezat	xâhi bord
budeš øíkat	xâhi goft
budeš se ptát	xâhi porsid
budeš se stávat	xâhi šod
budeš slyšet	xâhi šenid
budeš spát	xâhi xâbid
budeš vìdìt	xâhi dânest
budeš zavírat	xâhi bast
budete	xâhid bud
budete dìláni	karde xâhid šod
budete dìlat	xâhid kard
budete hrát	bâzi xâhid kard
budete chtít	xâhid xâst
budete jíst	xâhid xord
budete lámat	xâhid šekast
budete mít	xâhid dâšt
budete odpovídat	javâb xâhid dâd
budete pít	xâhid âšâmid
budete poèítat	xâhid šomord
budete øezat	xâhid bord
budete øíkat	xâhid goft
budete se ptát	xâhid porsid
budete se stávat	xâhid šod
budete slyšet	xâhid šenid
budete spát	xâhid xâbid
budete vìdìt	xâhid dânest
budete zavírat	xâhid bast
budík	sâat zangdar
budka	bâje
budou	xâhand bud
budou dìláni	karde xâhand šod
budou dìlat	xâhand kard
budou hrát	bâzi xâhand kard
budou chtít	xâhand xâst
budou jíst	xâhand xord
budou lámat	xâhand šekast
budou mít	xâhand dâšt
budou odpovídat	javâb xâhand dâd
budou pít	xâhand âšâmid
budou poèítat	xâhand šomord
budou øezat	xâhand bord
budou øíkat	xâhand goft
budou se ptát	xâhand porsid
budou se stávat	xâhand šod
budou slyšet	xâhand šenid
budou spát	xâhand xâbid
budou vìdìt	xâhand dânest
budou zavírat	xâhand bast
budovat	sâxtan
budu	xâham bud
budu dìlán	karde xâham šod
budu dìlat	xâham kard
budu hrát	bâzi xâham kard
budu chtít	xâham xâst
budu jíst	xâham xord
budu lámat	xâham šekast
budu mít	xâham dâšt
budu odpovídat	javâb xâham dâd
budu pít	xâham âšâmid
budu poèítat	xâham šomord, xâham šomord
budu øezat	xâham bord
budu øíkat	xâham goft
budu se ptát	xâham porsid
budu se stávat	xâham šod
budu slyšet	xâham šenid
budu spát	xâham xâbid
budu vìdìt	xâham dânest
budu zavírat	xâham bast
bufet	bufe
Bùh	Xodâ
bùh	parvardegâr, yazdân, izad
Bùh tì provázej	Xodâ negahdâr
buk	âleš, zân
byl	bud
byl bıval	bude bud
byl dìlán	karde šod
byl jsem	budam
byl jsem bıval	bude budam
byl jsem dìlán	karde šodam
byl jsem snìdl	xorde budam
byl jsem udìlal	karde budam
byl jsem udìlán	karde šode budam
byl jsi	budi
byl jsi bıval	bude budi
byl jsi dìlán	karde šodi
byl jsi snìdl	xorde budi
byl jsi udìlal	karde budi
byl jsi udìlán	karde šode budi
byl snìdl	xorde bud
byl udìlal	karde bud
byl udìlán	karde šode bud
byli	budand
byli bıvali	bude budand
byli dìláni	karde šodand
byli jsme	budim
byli jsme bıvali	bude budim
byli jsme dìláni	karde šodim
byli jsme snìdli	xorde budim
byli jsme udìlali	karde budim
byli jsme udìláni	karde šode budim
byli jste	budid
byli jste bıvali	bude budid
byli jste dìláni	karde šodid
byli jste snìdli	xorde budid
byli jste udìlali	karde budid
byli jste udìláni	karde šode budid
byli snìdli	xorde budand
byli udìlali	karde budand
byli udìláni	karde šode budand
byt	šabestân
bıt	budan
bıt schopen	tavânestan
bıt vdìènı	majbur budan
bıvá	mibâšad
bıvají	mibâšand
bıval	mibud
bıval jsem	mibudam
bıval jsi	mibudi
bıvali	mibudand
bıvali jsme	mibudim
bıvali jste	mibudid
bıvám	mibâšam
bıváme	mibâšim
bıváš	mibâši
bıváte	mibâšid
cedit	sâf kardan
cedník	sâfi
cedr	sedr
cedulka	barcasb
celer	karafs
celní	gomroki
celnice	gomrok
celulóza	seluloz
celı	tamâm
cement	simân
cena	bahâ, qeymat
centrum	miyâne
cesta	râh
cestování	mosâferati
cestovat	mosâferat kardan
cestovatel	mosâfer
cestovní kanceláø	ââns e mosâferati, bongâh e mosâferati
cestovní pas	gozarnâme
cestující	mosâfer
cibule	piyâz
cigareta	sigâr
cihla	âjor
cikán	kuli
cikánskı	kuli
cílevìdomı	bâ'erâde
cín	sorb, qal'
cíp	guše
církev	mezhab, ruhâniyat
církevní	mezhabi
císaø	šâh, pâdšâh
cit	hes
citron	limu
citronovı	limuyi
cizoloství	bivafâyi, zenâ, bituzeši
co	ci, ce
cokoliv	har ciz, har kâr
conânke	jak, jako
cuketa	kadu
cukr	šekkar
cukrárna	širiniforuši
cukynì	kadu
cupanina	katân
cypøiš	sarv
è (hláska)	c (horuf)
èaj	cây
èajovna	qahvexâne
èalamáda	torši
èára	xatt
èas	vaqt, asr, zamân
èasopis	majalle
èasovı	zamâni
èasto	bârhâ
èastı	bârhâ
èasy	owqât
èekárna	otâq e entezâr, sâlon e entezâr
èekat (na)	sabr kardan
èelist	fak
èelní	az sar, sarbesar
èelo	pišâni
èenich	puze
èenichat	pu kardan
èepec	kolâh
èepelka (holicí)	xodtarâš
èepice	kolâh
èerò	meški
èernı	siyâh, meški
èernı kašel	siyâhsorfe
èerpadlo	pomp
èerstvı	tâze
èert	ahriman
èerven	uan, uan
èervená	qermez
èervené zelí	kalam e qermez
èervenec	uye, uye
èesaná pøíze	nax e pašm, pašmi
Èeská republika	Jomhuri ye Ceki
èeskı	ceki
èesnek	sir
èéška	kaškak
èetaø	goruhbân
èí	az ân e ke
èinit	kardan
èíslo	šomâre, adad
èíslo domu	šomâre ye xâne
èíst	xândan
èistírna	xoškšuyi
èistotnı	pâkize
èlen	andâm
èlovìk	âdâm, fard, ensân
èlun	qâyeq
èoèka	adas
èokoláda	šoklât, šokolât
èokoládovı	šoklâti
ètrnáct	cahârdah
ètverec	cahârguš
ètvrt	robh
ètvrtek	panjšanbe
ètvrtina	cahârom, cârak
ètvrtı	cahârom
ètyøi	cahâr
ètyøi sta	cahârsad
ètyøicet	cehel
dá	xâhad dâd
ïábel	ahriman, div
dají	xâhand dâd
dal	dâd
dal jsem	dâdam
dal jsi	dâdi
daleko	dur, kenâr
dalekı	dur
dali	dâdand
dali jsme	dâdim
dali jste	dâdid
dám	xâham dâd
dáma	bânu
dáme	xâhim dâd
dámská vloka	dastmâl e behdâšti
dámy	bânuvân
Dánsko	Dânmârk
dáš	xâhi dâd
dát	dâdan, baxšidan
dáte	xâhid dâd
datle	xormâ
dává	midehad
dávají	midehand
dával	midâd
dával jsem	midâdam
dával jsi	midâdi
dávali	midâdand
dávali jsme	midâdim
dávali jste	midâdid
dávám	mideham
dáváme	midehim
dáváš	midehi
dávat	dâdan
dáváte	midehid
dcera	doxtar
dcera strıce z matèiny strany	doxtar-e-dâyi
dcera strıce z otcovy strany	doxtar-e-ammu
dcera tety z matèiny strany	doxtar-e-xâle
dcera tety z otcovy strany	doxtar-e-amme
debata	bahs
debatovat	bahs kardan
dìdeèek	pedarbozorg
dìdictví	abarmând
dìjepis	târix
dìjiny	târix
dìkovat	tašakor kardan, sepas gozârdan, tešaker kardan
dìkuji	motašakkeram, motešakeram, sepâs gozâram
dìlá	mikonad
dìlají	mikonand
dìlal	kard
dìlal jsem	kardam
dìlal jsi	kardi
dìlali	kardand
dìlali jsme	kardim
dìlali jste	kardid
dìlám	mikonam
dìláme	mikonim
dìlanı	karde
dìláš	mikoni
dìlat	kardan
dìláte	mikonid
dìlával	mikard
dìlával jsem	mikardam
dìlával jsi	mikardi
dìlávali	mikardand
dìlávali jsme	mikardim
dìlávali jste	mikardid
dìlej	kon
délka	derâzi
démon	jen, div
demonstrace	nemâyeš
den	ruz
den pracovního klidu	ruz e tatil
denní	ruzâne
denominace	mezhab
denominaèní	mezhabi
dentista	dandânpezešk
deodorant	zedd e bu
deprese	afsordegi
deset	dah
desetiletí	dahsâle
desetina	dahom
déš	bârân
dìtskı	baccegâne
devadesát	navad
devatenáct	nuzdah
dìvèe	doxtarce
devìt	noh
devìt set	nohsad
devítina	nohom
dezert	deser
dezodorant	zedd e bu
dialog	goftogu
dieta	parhiz
dík	sepâs
diskutovat	bahs kardan
diskuze	bahs, goftogu
dítì	bacce, kudak
dítko	bacce
divadlo	teâtr
dívka	dušize, doxtar
divokı vepø	gorâz
dlouho	moddat
dlouhı	derâz
dluh	qarz
dnes	emruz
dnes veèer	emšab
dno	te, kaf
do	be, suye, besuye
doba	zamân
dobro	xubi, xub
dobroøeèit	yaštan
dobrota	xubi
dobrou noc	šab be xeyr
dobrı	beh, xub
dodrovat	negâh dâštan
dohromady	bâham
dojit	dušidan
dolar	dolâr
dole	pâyine, pâyin, zire
dolù	pâyine, zire, pâeyn
domov	âvareš
dopis	nâme
dopisní papír	kâqaz e yâddâšt
doporuèit	pišnahâd kardan
dopøedu	bejelow
dost	bas, kâfi
dostat	gereftan
dostateènı	kâfi, farâvân
dostatek	farâvâni, farâvân, besyâr
dostává	migirad
dostávají	migirand
dostávám	migiram
dostáváme	migirim
dostáváš	migiri
dostávat	gereftan
dostáváte	migirid
dozrávat	rasidan
drahokam	zivar
drahı	aziz, gerân
drak	bâdbâdâk
drama	drâm
drát	sim
drátìnı	turi
draší	gerântar
drn	caman
dršky	sirâbi
drùbky	del o jegar e qâz
druhá tøída (ve vlaku)	daraje ye do
druhı	dovom
druice	mâhvâre
dret	negâh dâštan
døina	zahmat
døíve	zudtar
duben	âvril, Âvril
duch	jân, ravân, ruh, faravahr
dùl	kân
dùm	xâne, sarây, kad
duše	jân, ravân
dušené maso se zeleninou	xoreš
dùvìra	bâvar
dva	do
dva tisíce	do hezâr
dvacet	bist
dvakrát	do bâr
dvanáct	davâzdah
dvì stì	devist
dveøe	dar, dâr
dvoulùkové kupé	kupe ye dotaxti
dım	dud
dynamo	dinâm
dınì	kadu ye mosammâyi
d (hláska)	j (horuf)
dbán	kuze
dez	jâz
din	jen
díny	šalvâr e jin
elegantní	zibâ
elektrické hodiny	sâat e elektriki
elektrickı holicí strojek	xodtarâš e barqi
eso	takxâl, âs
eštehâ	chu
etiketa	barcasb
Evropa	Orupâ
evropskı	orupâyi
existence	zist
existuje	mibâšad
existujeme	mibâšim
existuješ	mibâši
existujete	mibâšid
existuji	mibâšam
existují	mibâšand
expanze	afzâyeš
extáze	azxodbixodšodegi
familiární	âšnâ
fašismus	fâšism
fašista	fâšist
fašistickı	fâšisti
federace	federâsiyon
federativní	federâl
fén	muxoškkon
fialovı	banafš
fík	anjir
film	film
filtr	filter
filtr (cigar.)	filterdâr
flanel	pârce ye pašmi (sad dar sad)
folk	musiqi ye mardomi
folková hudba	musiqi ye mardomi
fondán	sarehambandi
fotbal	futbâl
fotoaparát	durbin e akkâsi
francouzskı	farânsavi
frank	frânk
galaxie	kahkašân
galerie	sarsarâ, negârestân
gará	gârâ
garnát	meygu
gáza	gâz e pânsomân
geografie	joqrâfiyâ
gesto	ešâre
golf	golf
grafém	harf
gram	gram
gramatika	dastur e zabân
gramofon	grâm
granátové jablko	anâr
grapefruit	pâmplimus
grep	pâmplimus
guma	medâd pâkkon, medâdpâkkon, lâstik
gumovı	lastiki
had	mâr
hádanka	cistân
hadi	haji
halasnı	boland
hamburger [hamburgr]	hamberger
hedvábí	abrišom, âbrišom
hegemonie	bartari
hektickı	biâram
helikoptéra	helikopter
hemoroidy	bavâsir
hereze	zandegi
hezkı	qašang, zibâ
historie	târix
hladovı	gorosne
hlásat	pand dâdan
hlasitı	boland
hláska	horuf
hlava	sar
hlávkovı salát	kâhu
hledat	jostoju kardan
hloubka	arfâ
hlubokı	arf, gud
hluchı	kar
hned	fori
hnìdı	qahve i
ho	urâ
hodina	vaqt, sâat
hodináøství	sâatsâzi
hodinky	sâat
hodiny	sâat e divâri
hodnì	xeyli, ziyâd
hodnota	arzeš, bahâ
hoch	pesar
holicí strojek (elektr.)	rištarâš
holièství	ârâyešgâh
holit	tarâšidan
holit se	riš tarâšidan
holub	kabutar
hora	kuh
horeèka	tab
horká èokoláda	šir kâkâo
horkı	âtašin, garm
horlivı	bâqeyrat
horší	badtar
hoøèice	xardal
hoøkı	talx
Hospodin	Xodâvand
host	mehmân
hostinec	mehmânxâne, mosâferxâne
hot dog	hâtdâg
hotel	hotel
hotelovı zøízenec	pâdow, šâgerd
houba	espanj, qârc
houf	dam
hovìzí (maso)	gušt e gâv
hovoøit	harf zadan
hra	namâyešnâme, bâzi
hra (drama)	namâyeš
hrací karta	varaq e bâzi
hraèkáøství	asbâb e bâziforuši
hrách	naxod
hrách (zelenı)	noxod e sabz
hraje	bâzi mikonad
hrajeme	bâzi mikonim
hraješ	bâzi mikoni
hrajete	bâzi mikonid
hraji	bâzi mikonam
hrají	bâzi mikonand
hrál	bâzi kard
hrál jsem	bâzi kardam
hrál jsi	bâzi kardi
hráli	bâzi kardand
hráli jsme	bâzi kardim
hráli jste	bâzi kardid
hranice	marz
hrát	bâzi kardan
hrával	bâzi mikard
hrával jsem	bâzi mikardam
hrával jsi	bâzi mikardi
hrávali	bâzi mikardand
hrávali jsme	bâzi mikardim
hrávali jste	bâzi mikardid
hrdina	delâvar
hrdlo	galu
hrnek	fenjân
hrob	gur
hrobka	gur
hrozen	angur
hrtan	galu
hruï	sine, pestân
hrudník	sine
hruška	golâbi, amrud
høbet	sotun e faqarât
høbitov	ârâmgâh, gurestân
høeben	šâne, šane
høib	gârc, qârc
høích	gonâh, bezeh, âstâr
høíšník	gonâhkâr, bezehkâr
høíva	yâl
hudba	musiqi, xoniyâ
husa	qâz
hustilka	tolombe
hvìzda	setâre
hvìzdáø	setârešenâs
hymna	sorud
ch (hláska)	x (horuf)
charakter	nahâd
chata	kolbe, kalbe
chce	mixâhad
chceme	mixâhim
chceš	mixâhi
chcete	mixâhid
chci	mixâham
chladicí systém	havâkaš
chladiè	râdiyâtor, radiâtor
chladnı	sard
chlapec	pesar
chlazení	havâkaš
chléb	nân
chlebíèek	gerd e nân e kucek
chlév	kâvdâni
chlór	klor
chlup	pašm
chmel	râzak
choï	râh boro
chodit	râh raftan
chodník	piyâde row, piyâderow
chování	raftâr
chrabrost	arvandi
chrom	krom
chronickı	mozmen
chronologie	šarh e târixi, târixšomâri
chøest	mârcube
chøipka	ânfluânzâ
chtìjí	mixâhand
chtìl	xâst
chtìl jsem	xâstam
chtìl jsi	xâsti
chtìli	xâstand
chtìli jsme	xâstim
chtìli jste	xâstid
chtít	xâstan
chu	eštehâ
chutnı	laziz
chvála	setâyeš
chválit	setâyeš kardan
chyba	eštebâh, ârang
chybovat	eštebâh namudan
chystat	âmâde šodan
chytat	gereftan
chytit	gereftan
i	niz, ham, va, o
ideální	ârmân, ideâl
Indie	Hend, Hendustân
infekce	cerkkardegi
informace	âgâhi
inkoust	jowhar
inenır	mohandes
ion	yon
Irák	Arâq
Írán	Irân
Íránská islámská republika	Jomhuri ye Eslami ye Irân
íránskı	irâni
islám	islâm, eslâm
islámskı	islâmi, eslâmi
Island	Island
islandskı	Islandi
Itálie	Itâliyâ
izolace	âyeq-sâzi
Izrael	Esrâil
j (hláska)	y (horuf)
já	man
jablko	sib
jadernı	hasteyi, atomi
jádro	haste
jahoda	tut e farangi
jak	cetor, cegune, cetowr
jak mnoho	cand
jako	conânke, mesl, mânande, con
jakı	ce, cetowr, ci, cand, kodâm
jáma	cah
jantar	kahrobâ
jaro	bahâr
játra	jegar
jazyk	barge, zabân
jazz [dez]	jâz
jde	miravad
jdeme	miravim
jdeš	miravi
jdete	miravid
jdi	boro
jdou	miravand
jdu	miravam
je (akuzativ zájmena)	ânhârâ
je dìlán	karde mišavad
je dìláván	karde mišod
je udìlán	karde šode'ast
je(st)	hast
jed	sam, zahr
jeden	yek
jedenáct	yâzdah
jedenkrát	yek bâr
jedí	mixârand
jedl	xord
jedl jsem	xordam
jedl jsi	xordi
jedli	xordand
jedli jsme	xordim
jedli jste	xordid
jednoduchı	sâde
jednoho dne	yekruz
jednolùkové kupé	kupe ye yektaxti
jednostrannı	yekpahlu
jednotlivı	nafar
jednou	yekruz, yek bâr
Jedu do Teheránu.	Man be Tehrân miravam.
jehla	suzan
jehlice do kravaty	suzan e kerâvât
jehnì	barre
jeho	e u, -aš
jej	urâ
jejich	e išân, -ešan
jelen	gavazn
jemnı	zarif
jemu	beu
jen	tanhâ, yegâne
jenom	yegâne, tanhâ
jest	ast
jestli	agar
ještì	hanuz
jet	rândan
jevit se	nemudan, namudan
jez (jíst)	boxor
jezero	daryâce
jezírko	berke
Jeíš	Eysa, Eysâ, Isâ
Jeíš Kristus	Isâ Masih
jho	yuq
jí	mixârad
jídelní vùz	vâgon e qazâxori
jídlo	qazâ
jih	jonub
jikry	toxm e mâhi
jim	be ânhâ
jím	mixâram
jim (pro osoby)	be išân
jíme	mixârim
jinı (další)	digar
jíst	xordan
jistı)	-i
jistı) po samohlásce	-yi
jíš	mixâri
jít	raftan
jíte	mixârid
jízdenka	belit
jízdní kolo	docarxe
jízdní øád	ketâb e râhnamâ ye râh-âhan
jméno	nâm, esm
jmenovat	gomârdan
jód	yod
jsem	hastam, am
jsem dìlán	karde mišavam
jsem dìláván	karde mišodam
jsem udìlán	karde šode'am
jsi	hasti, i
jsi dìlán	karde mišavi
jsi dìláván	karde mišodi
jsi udìlán	karde šode'i
jsme	hastim, im
jsme dìláni	karde mišavim
jsme dìláváni	karde mišodim
jsme udìláni	karde šode'im
jsou	hastand, and
jsou dìláni	karde mišavand
jsou dìláváni	karde mišodand
jsou udìláni	karde šode'and
jste	id, hastid
jste dìláni	karde mišavid
jste dìláváni	karde mišodid
jste udìláni	karde šode'id
k	besuye, suye, be
kabát	pâlto
kabel	kâbl
kadeønictví	ârâyešgâh e zanâne
kachna	ordak
kalamáø	davât
kalamita	balâ, badbaxti
kalendáø	sâlnâme, gâhnamâ
kalhoty	šalvâr, šalvar
kalkulovat	hesâb kardan
kamarád	dust
kambala velká	mâhi ye sim
kamenovat	sangsâr kardan
kamion	kâmiyon
kampaò	mobâreze, laškarkaši
Kanada	Kanada
kanál	kânâl
kanystr	pit
kapacita	gonjâyeš
kapesní hodinky	sâat e jibi
kapesník	dastmâl
kapky do oèí	qatre ye cešm
kapky do uší	qatre ye guš
kapsa	jib
kára	gâri
karafa	tong
karamel	kârâmel
karát	qirât
karavan	kârevân
karbanátek	kufte ye rize
karbonovı papír	meqdâr kârbon
karburátor	karburâtor
kard	xâhim
kardinál	kârdinâl
karotka	zardak
kartáè	bros
kartáèek na nehty	bros e nâxon
kartáèek na zuby	dandânšuy
karton	kârton
kaštan	šâhbalut
katalog	ketâb e fehrest
katedra	miz
káva	qahve
kavárna	qahvexâne
kaviár	xâviyâr
kávovar	sâfi
kázat	pand dâdan
kazeta	kâset
kadı	har
kadı den	har ruz
kde	kojâ
kdekoliv	har kojâ, har jâ
kdo	ki
kdy	key
kdy	vaqti
kedluben	šalqam
kedlubna	šalqam
kempink	ordugâh, kemping
keramickı	serâmiki
keramika	serâmik
keø	bute
ké bych	omidâram ke
kilo	kilo
kilogram	kilo
kilometr	kilumetr, kilometr
kino	sinemâ, sinema
klakson	buq
klávesnice	kibord
klenot	zivar
klenotnice	gowhardân
klepat (na dveøe)	dar zadan
klíè	kelid
klíèní kost	ostoxân e tarqove
klid	ârâmeš, âsudegi
klidnı	ârâm
klientela	gomrok
klikovı høídel	milelang
klobása	sosis
klobouk	kolâh
kloub	mafsal
kluk (karty)	sarbâz
kniha	ketâb
knihkupectví	ketâbforuši
knihovna	ketâbxâne
knihy	kotob
knír	sebil
knoflík	dokme
koberec	qâli, farš
koèka	gorbe
kohout	xorus
kokos	nârgil
koláè	koluce, keyk
kolem	atrâf, gerdâgerd, pirâmun
koleno	zânu
kolik	cand, ceqadr
kolo	carx
komár	paše
kombinéza	bâlâpuš
komedie	komedi
komorník	pišxedmat
konat	kardan
konat práci	kâr kardan
kondice	hâl
konec	âxar, pâyân
konvice	quri
konzerva	quti
konzulát	konsulgari
kopaná	futbâl
kopec	tappe
kopøiva	gazane
korál	marjân
korán	qorân
Korea	Kore
kormidlo	nok
koroptev	kabk
koruna	tâj
kos	zâqi
kosa	dâs
kosmetickı salon	sâlon e zibâyi
kost	ostoxân
kostel	kelisâ
kostka cukru	qand
kostım	jâme
koš	sabad
košile	pirâhan
koštì	jârub
kotleta	kotlet
kotlík	dig
kotník	moce pâ
koupací èepice	kolâh e šostošu
koupací pláš	howle ye hammâm
koupelna	hammâm
koupit	xaridan
kouøení zakázáno	estemâl e doxâniyât mamnu ast
kousat	gazidan
kouzlo	jâdu
koenı	carmi
koich	kot e xaz
krabice	qoti, ja'be
krachlı	varšekaste
krajka	pârce ye turi
král	soltân, pâdšâh, šâh
Král králù	Šâh e šâhân
král králù	šâhânšâh
králík	xarguš
královna	šahrbânu, šahbânu
královsky	šâhvâr
královskı	šâhânšâhi
království	pâdšâhi
krása	zibâyi, xošgeli
kráska	xošgel
krásnı	zibâ, qašang
krátkı	kutâh
kratochvíle	sargami
kratší	kutâhtar
kráva	gâv
kravata	krâvât, dastmâl e gardan
kreditní karta	kârt e e'tebâr
krejèí	darzi
krém	kerem
krém na opalování	kerem e âftâb
krém na ruce	kerem e dast
kreslicí papír	kâqaz e naqqâši
kreslit	âhixtan
krev	xun
krk	gardan
krocan	pilmorq, buqalamun
krok	gâm
krupice	balqur
krùta	buqalamun, pilmorq
køeè	enqebâz e mâhice, tašannoj
køepelka	beldercin
køesan	masihi
køídlo	bâl
køí	salib
køiovatka	cahârrâh
kterı	ce, ci, kodâm
kufr	jâmedân
kukuøice	zorrat
kulatı	gerd
kùò	asb
kupé	kupe
kupøedu	bejelow
Kurdistán	Kordestân
kuøe	morq
kuøe(cí)	juje
kùe	pust, carm
kvìt	gol
kvìták	gol-kalam, gol e kalam
kvìten	me
kvìtináøství	golforuši
kıla	bâd e fatq
kyselı	torš
labutìnka	gard e pof
lacinı	arzân
láhev	botri
lak	lâkalkol
lak na nehty	lâk e nâxon
lak na vlasy	tâft, gisuafšân
lámal	šekast
lámal jsem	šekastam
lámal jsi	šekasti
lámali	šekastand
lámali jsme	šekastim
lámali jste	šekastid
lámat	šekastan
láme	mišekandad
lámeme	mišekandim
lámeš	mišekandi
lámete	mišekandid
lámou	mišekandand
lampa	cerâq, lâmp
lámu	mišekandam
laò	âhu
lanı	dombalân
láska	ešq, mehr
laskavost	xubi
laskavı	mehrbân
latinka	xatt e lâtin
latinskı	lâtin
látka	pârce
lavice	miz, nimkat
lavor	lagan
lázeò	hammâm
léèivo	dâru
léèka	dâm
led	yax
leden	ânvie, ânvie
ledvina	qolve, kolye
ledvinka	qolve
lehátko	sandali ye âsâyeš
lehkı	sâde, sabok
lék	dâru
lékárna	dâruxâne
lékárnièka	ja'be ye komakhâ ye naxostin
lékaø	pezešk
lékaøskı pøedpis	nosxe
lékaøství	pezeški
lepidlo	casb
lepit	casbândan
lepší	behtar
les	jangal, biše
lesní	jangali
letadlo	havâpeymâ
letištì	forudgâh
léto	tâbestân
leukoplast	casb e zaxm
lev	šir
levnìjší	arzântar
levnı	arzân
levı	cap
libra	pond
líce	gune
lidé	bastegân
lidskı rod	neâd e ensân
lilek (jedlı)	bâdenjân
límec	yaqe
limonáda	limunâd
linka	xatt
lískovı oøíšek	fandoq
list	barg, varaq
lístek	belit
listopad	novâmbr
lítost	tâssof
litr	litr
lnìná tkanina	panbeyi, pârce ye katâni
loï	zoraq, kašti
loket	âranj
loni	pârsâl
losos	mâhi ye âzâd
louka	camanzâr
loutna	ud
lonice	otâq e xâb, xâbgâh
lùko	bastar, raxtexâb
lysı	kacal
líce	qâšoq
má	dârad
magnetofon (kazet.)	zabt e sowt
majetek	mâl
mají	dârand
makrela	mâhi ye xâldâr
malina	temešk
málo	kam
malovat	âhixtan
malı	xorde, kucak, kucek
mám	dâram
máma	mâmâ
máme	dârim
mandarinka	nârangi
mandle	bâdâm
mandle (anat.)	lowze, bâdâmak
manévrovat	neyrang zadan
mango	anbe
maniak	âtaši
manikúra	mânikur
manšestr	maxmal
manel	šowhar
manelka	hamsar
maneta	dokme ye sardast
mapa	naqše
mapa velkého mìøítka	naqše bâ meqyâs e bozorg
Marie	Maryam
marka	mârk
marmeláda	morabbâ
máslo	kare
masna	guštforuši
maso	gušt
mastnı	carb
máš	dâri
mat	mât
máte	dârid
materiál	pârce
matice	mohre
matka	mâdar
matka (u šroubu)	mohre
matrace	tošak
mì	manrâ
meè	šamšir
med	asal
mìï	mes
medvìd	xers
mìj rád	dust bedâr
mìl	dâšt
mìl jsem	dâštam
mìl jsi	dâšti
mìli	dâštand
mìli jsme	dâštim
mìli jste	dâštid
meloun	hendavâne
membrána	parde
ménì	kamtar
mìniè	trânsformâtor
menší	kucaktar, xordtar
meruòka	zardâlu
mìøítko	meqyâs
mìsíc	mâh
mìsto	šahrak, šahr
mìstská policie	šahrbâni
mešita	masjed
metr	metr, meter
metro	metro
mezi	darmiyâne, andar, beyn
mi	beman
míè	tup
mikina	bluz
mikrobus	minibus
milenec	dustdâr, âšeq
miliarda	miliyârd, miliârd
milion	miliyon, milion
milosrdenství	baxšeš, baxšâyandegi, delsuzi
milost	sangini, vaqâr
milostnı	kerešme
milovat	ešq budan
milı	xoš, aziz
mince	sekke
ministrynì	vazir
ministøi	vozarâ
minuta	daqiqe
mír	âsâni, ârâmeš, âšti
miska	kâse
místnost	otâq
místo	jâ
místo	jâ
místodritelství	velâyat
mít	dâštan
mít platnost	etebâr dâštan
mít rád	dust dâštan
mít sen	xâb didan
míval	midâšt
míval jsem	midâštam
míval jsi	midâšti
mívali	midâštand
mívali jsme	midâštim
mívali jste	midâštid
mixér	hamzan
mladı	javân
mléko	šir
mlhavı	mehâlud
mluv	harf bezan
mluvit	harf zadan
mluvnice	dastur e zabân
mlın	âsyâb
mne	manrâ
mnì	beman
mnoho	ziyâd, xeyli
moc	amâvandi, qodrat
moci	tavânestan
moè	ure
modlit se	niyâyeš kardan, namâz kardan
modlitba	niyâyeš, namâz
modrı	âbi
modø	kabud
Mohamed	Mohammad
mokro	xis
mol	bid
Morava	Morâviyâ
moruše	tut
moøe	daryâ
most	pol
motocykl	motorsiklet
motorovı èlun	qâyeq e motori
motorovı olej	rowqan e motor
motıl	parvâne
mouèník	keyk
mouka	ârd
mozek	maqz
moná	šâyad
mono	momken
monı	momken
mrak	abr
mrdat	gâyidan
mrkev	havij
mùj	-am, e man
mul	gâz e pânsomân
muset	bâyad, bâyast
muslim	mosalmân
muzeum	muze
mu	mard
munı	mardâne
my	mâ
mıdlo	sâbun
mılit se	eštebâh namudan
myslet	fekr kardan, andišidan
myšlenka	andiše
na	bar
na prodej	barâye foruš
na shledanou	Xodâ negahdâr, be omid e didâr
na vidìnou	be omid e didâr
náboenská obec	mezhab
náboenství	din
nacista	nâzi
náèrtník	kâqaz e pišnevis
nad	bâlâye, bartar, zabar, ruye
nadìje	omid
Náder	Nâder
nádhernı	zibâ
nádobí	zarf
nádraí	istgâh
nahoru	bâlâ
náhradní díly	qesmathâ ye yadaki
nacházet	peydâ kardan
nachlazení	sarmâxordegi
najdi	peydâ kon
najmout	ejâre kardan
nákaza	cerkkardegi
nakládaná)	xiyâr e šur
nákladnı	gerân
náklonnost	gerâmegi
nákup	xarid
nalézat	peydâ kardan
nám	bemâ
námìstí	meydân
námoøní	daryâyi
napájel jsem se	miâšâmidam
napájel jsi se	miâšâmidi
napájel se	miâšâmid
napájeli jsme se	miâšâmidim
napájeli jste se	miâšâmidid
napájeli se	miâšâmidand
napìtí	voltâ
napij se	benuš
napít se	nušidan
náplast	casb e zaxm
nápoj	nušâne
naproti	ruberuye, vâ
napøíè	sartâsar
náramkové hodinky	sâat e moci
národ	pâdarm, mellat
národní	melli, pâdarmi
národní osvobození	nejât e melli
narození	zâyeš
narozeniny	tavvalod
náøadí	abzâr
naøízení	âyinnâme
nás	mârâ
nástraha	dâm
nástroj	afzâr
nástupištì	saku
náš	-eman, e mâ
natáèka	bigudi
nátìlník	ile
nauky	olum
náušnice	gušvâre
navrhnout	pišnahâd kardan
navdy	barâye hamiše, peyvaste, jâvidân
nazdar	dorud
název	nâm
ne	nah, xeyr, na
ne-	ne-, na-
nebe	âsmân, behešt, minu
nebeskı	âsmâni
nebezpeèí	se, xatar
nebezpeèí smrti	xatar e marg
nebezpeènı	xatarnâk
neblahı	badbaxt
nebo	yâ
nebo	conke, zirâ
nebude	naxâhad bud
nebude dìlán	karde naxâhad šod
nebude dìlat	naxâhad kard
nebude hrát	bâzi naxâhad kard
nebude chtít	naxâhad xâst
nebude jíst	naxâhad xord
nebude pít	naxâhad âšâmid
nebude poèítat	naxâhad šomord
nebude spát	naxâham xâbid
nebude vìdìt	naxâhad dânest
nebude zavírat	naxâhad bast
nebudeme	naxâhim bud
nebudeme dìláni	karde naxâhim šod
nebudeme dìlat	naxâhim kard
nebudeme hrát	bâzi naxâhim kard
nebudeme chtít	naxâhim xâst
nebudeme jíst	naxâhim xord
nebudeme pít	naxâhim âšâmid
nebudeme poèítat	naxâhim šomord
nebudeme spát	naxâhim xâbid
nebudeme vìdìt	naxâhim dânest
nebudeme zavírat	naxâhim bast
nebudeš	naxâhi bud
nebudeš dìlán	karde naxâhi šod
nebudeš dìlat	naxâhi kard
nebudeš hrát	bâzi naxâhi kard
nebudeš chtít	naxâhi xâst
nebudeš jíst	naxâhi xord
nebudeš pít	naxâhi âšâmid
nebudeš poèítat	naxâhi šomord
nebudeš spát	naxâhi xabid
nebudeš vìdìt	naxâhi dânest
nebudeš zavírat	naxâhi bast
nebudete	naxâhid bud
nebudete dìláni	karde naxâhid šod
nebudete dìlat	naxâhid kard
nebudete hrát	bâzi naxâhid kard
nebudete chtít	naxâhid xâst
nebudete jíst	naxâhid xord
nebudete pít	naxâhid âšâmid
nebudete poèítat	naxâhid šomord
nebudete spát	naxâhid xâbid
nebudete vìdìt	naxâhid dânest
nebudete zavírat	naxâhid bast
nebudou	naxâhand bud
nebudou dìláni	karde naxâhand šod
nebudou dìlat	naxâhand kard
nebudou hrát	bâzi naxâhand kard
nebudou chtít	naxâhand xâst
nebudou jíst	naxâhand xord
nebudou pít	naxâhand âšâmid
nebudou poèítat	naxâhand šomord
nebudou spát	naxâhand xâbid
nebudou vìdìt	naxâhand dânest
nebudou zavírat	naxâhand bast
nebudu	naxâham bud
nebudu dìlán	karde naxâham šod
nebudu dìlat	naxâham kard
nebudu hrát	bâzi naxâham kard
nebudu chtít	naxâham xâst
nebudu jíst	naxâham xord
nebudu pít	naxâham âšâmid
nebudu poèítat	naxâham šomord
nebudu spát	naxâham xabid
nebudu vìdìt	naxâham dânest
nebudu zavírat	naxâham bast
nebyl	nabud
nebyl dìlán	karde našod
nebyl jsem	nabudam
nebyl jsem dìlán	karde našodam
nebyl jsem udìlal	nakarde budam
nebyl jsem udìlán	karde šode nabudam
nebyl jsi	nabudi
nebyl jsi dìlán	karde našodi
nebyl jsi udìlal	nakarde budi
nebyl jsi udìlán	karde šode nabudi
nebyl udìlal	nakarde bud
nebyl udìlán	karde šode nabud
nebyli	nabudand
nebyli dìláni	karde našodand
nebyli jsme	nabudim
nebyli jsme dìláni	karde našodim
nebyli jsme udìlali	nakarde budim
nebyli jsme udìláni	karde šode nabudim
nebyli jste	nabudid
nebyli jste dìláni	karde našodid
nebyli jste udìlali	nakarde budid
nebyli jste udìláni	karde šode nabudid
nebyli udìlali	nakarde budand
nebyli udìláni	karde šode nabudand
nebıval	namibud
nebıval jsem	namibudam
nebıval jsi	namibudi
nebıvali	namibudand
nebıvali jsme	namibudim
nebıvali jste	namibudid
necesér	ja'be ye abzârhâ ye ârâyeš
nìco	yek cizi, cizi
neèistotnı	cerk, nâpâk
neèistı	cerk
nedá	naxâhad dâd
nedají	naxâhand dâd
nedal	nadâd
nedal jsem	nadâdam
nedal jsi	nadâdi
nedali	nadâdand
nedali jsme	nadâdim
nedali jste	nadâdid
nedám	naxâham dâd
nedáme	naxâhim dâd
nedáš	naxâhi dâd
nedáte	naxâhid dâd
nedává	namidehad
nedávají	namidehand
nedával	namidâd
nedával jsem	namidâdam
nedával jsi	namidâdi
nedávali	namidâdand
nedávali jsme	namidâdim
nedávali jste	namidâdid
nedávám	namideham
nedáváme	namidehim
nedáváš	namidehi
nedáváte	namidehid
nedbale	behar hâl
nedìlá	namikonad
nedìlají	namikonand
nedìlal	nakard
nedìlal jsem	nakardam
nedìlal jsi	nakardi
nedìlali	nakardand
nedìlali jsme	nakardim
nedìlali jste	nakardid
nedìlám	namikonam
nedìláme	namikonim
nedìláš	namikoni
nedìláte	namikonid
nedìlával	namikard
nedìlával jsem	namikardam
nedìlával jsi	namikardi
nedìlávali	namikardand
nedìlávali jsme	namikardim
nedìlávali jste	namikardid
nedìle	yekšanbe
neexistuje	namibâšad
neexistujeme	namibâšim
neexistuješ	namibâši
neexistujete	namibâšid
neexistuji	namibâšam
neexistují	namibâšand
nefrit	yašm
nehraje	bâzi namikonad
nehrajeme	bâzi namikonim
nehraješ	bâzi namikoni
nehrajete	bâzi namikonid
nehraji	bâzi namikonam
nehrají	bâzi namikonand
nehrál	bâzi nakard
nehrál jsem	bâzi nakardam
nehrál jsi	bâzi nakardi
nehráli	bâzi nakardand
nehráli jsme	bâzi nakardim
nehráli jste	bâzi nakardid
nehrával	bâzi namikard
nehrával jsem	bâzi namikardam
nehrával jsi	bâzi namikardi
nehrávali	bâzi namikardand
nehrávali jsme	bâzi namikardim
nehrávali jste	bâzi namikardid
nechce	namixâhad
nechceme	namixâhim
nechceš	namixâhi
nechcete	namixâhid
nechci	namixâham
nechtìjí	namixâhand
nechtìl	naxâst
nechtìl jsem	naxâstam
nechtìl jsi	naxâsti
nechtìli	naxâstand
nechtìli jsme	naxâstim
nechtìli jste	naxâstid
nechvalnı	badbaxt
nìjak	yekjur
nìjakı	-i, andaki, -yi, pâreyi
nejasnı	âlude
nejbliší	nazdiktarin
nejdraší	gerântarin
nejdøíve	zudtarin
nejedí	namixârand
nejedl	naxord
nejedl jsem	naxordam
nejedl jsi	naxordi
nejedli	naxordand
nejedli jsme	naxordim
nejedli jste	naxordid
nejhorší	badtarin
nejí	namixârad
nejím	namixâram
nejíme	namixârim
nejíš	namixâri
nejíte	namixârid
nejkratší	kutâhtarin
nejlepší	behtaring, behtarin
nejlevnìjší	arzântarin
nejmenší	kucaktarin, xordtarin
nejsem	nistam
nejsem dìlán	karde namišavam
nejsem dìláván	karde namišodam
nejsem udìlán	karde našode'am
nejsi dìlán	karde namišavi
nejsi dìláván	karde namišodi
nejsi udìlán	karde našode'i
nejsme dìláni	karde namišavim
nejsme dìláváni	karde namišodim
nejsme udìláni	karde našode'im
nejsou dìláni	karde namišavand
nejsou dìláváni	karde namišodand
nejsou udìláni	karde našode'and
nejste dìláni	karde namišavid
nejste dìláváni	karde namišodid
nejste udìláni	karde našode'id
nejvìtší	bozorgtarin
nìkde	yek jâyi
nìkdo	yek kasi
neklidnı	biâram
nìkolik	cand
nekoneènı	bipâyân
nìkterı	pâreyi
Nìmecko	Âlmân
nìmeckı	âlmâni
nemocnice	bimârestân
nemocnı	bimâr
nenapájel jsem se	namiâšâmidam
nenapájel jsi se	namiâšâmidi
nenapájel se	namiâšâmid
nenapájeli jsme se	namiâšâmidim
nenapájeli jste se	namiâšâmidid
nenapájeli se	namiâšâmidand
není dìlán	karde namišavad
není dìláván	karde namišod
není udìlán	karde našode'ast
není zaè	xâheš mikonam
nepije	namiâšâmad
nepijeme	namiâšâmim
nepiješ	namiâšâmi
nepijete	namiâšâmid
nepiji	namiâšâmam
nepijí	namiâšâmand
nepil	nayâšâmid
nepil jsem	nayâšâmidam
nepil jsi	nayâšâmidi
nepili	nayâšâmidand
nepili jsme	nayâšâmidim
nepili jste	nayâšâmidid
nepoèítá	namišomorad
nepoèítají	namišomorand
nepoèítal	našomord
nepoèítal jsem	našomordam
nepoèítal jsi	našomordi
nepoèítali	našomordand
nepoèítali jsme	našomordim
nepoèítali jste	našomordid
nepoèítám	namišomoram
nepoèítáme	namišomorim
nepoèítáš	namišomori
nepoèítáte	namišomorid
nepojídá	namixord
nepojídal	namixord
nepojídal jsem	namixordam
nepojídal jsi	namixordi
nepojídali	namixordand
nepojídali jsme	namixordim
nepojídali jste	namixordid
nepojídám	namixordam
nepojídáme	namixordim
nepojídáš	namixordi
nepøicházejí	namiâyand
nepøichází	namiâyad
nepøicházím	namiâyam
nepøicházíme	namiâ'im
nepøicházíš	namiâ'i
nepøicházíte	namiâ'id
nepøijde	naxâhad âmad
nepøijdeme	naxâhim âmad
nepøijdeš	naxâhi âmad
nepøijdete	naxâhid âmad
nepøijdou	naxâhand âmad
nepøijdu	naxâham âmad
nepøinášejí	namiârand
nepøinášel	namiâvard
nepøinášel jsem	namiâvardam
nepøinášel jsi	namiâvardi
nepøinášeli	namiâvardand
nepøinášeli jsme	namiâvardim
nepøinášeli jste	namiâvardid
nepøináší	namiârad
nepøináším	namiâram
nepøinášíme	namiârim
nepøinášíš	namiâri
nepøinášíte	namiârid
nepøinese	naxâhad âvard
nepøineseme	naxâhim âvard
nepøineseš	naxâhi âvard
nepøinesete	naxâhid âvard
nepøinesl	nayâvard
nepøinesl jsem	nayâvardam
nepøinesl jsi	nayâvardi
nepøinesli	nayâvardand
nepøinesli jsme	nayâvardim
nepøinesli jste	nayâvardid
nepøinesou	naxâhand âvard
nepøinesu	naxâham âvard
nepøišel	nayâmad
nepøišel jsem	nayâmadam
nepøišel jsi	nayâmadi
nepøišli	nayâmadand
nepøišli jsme	nayâmadim
nepøišli jste	nayâmadid
nepøítel	došman
neradostnı	badbaxt
nerez ocel	pulâd e bizang
nerv	pey, asab
nervovı	asabi
nesmírnì	biš az andâze
nesnìdl	naxorde'ast
nesnìdl jsem	naxorde'am
nesnìdl jsi	naxorde'i
nesnìdli	naxorde'and
nesnìdli jsme	naxorde'im
nesnìdli jste	naxorde'id
nespal	naxâbid
nespal jsem	naxâbidam
nespal jsi	naxâbidi
nespali	naxâbidand
nespali jsme	naxâbidim
nespali jste	naxâbidid
nespával	namixâbid
nespával jsem	namixâbidam
nespával jsi	namixâbidi
nespávali	namixâbidand
nespávali jsme	namixâbidim
nespávali jste	namixâbidid
nespí	namixâbad
nespí (pl.)	namixâband
nespím	namixâbam
nespíme	namixâbim
nespíš	namixâbi
nespíte	namixâbid
neudìlal	nakarde'ast
neudìlal jsem	nakarde'am
neudìlal jsi	nakarde'i
neudìlali	nakarde'and
neudìlali jsme	nakarde'im
neudìlali jste	nakarde'id
neurèitı èlen (jeden	-i, -yi
nevìdìl	nadânest
nevìdìl jsem	nadânestam
nevìdìl jsi	nadânesti
nevìdìli	nadânestand
nevìdìli jsme	nadânestim
nevìdìli jste	nadânestid
nevìdí	namidânand
neví	namidânad
nevidomı	nâbinâ
nevím	namidânam
nevíme	namidânim
nevíš	namidâni
nevíte	namidânid
nevyjasnìnı	âlude
nezavírá	namibandad
nezavírají	namibandand
nezavíral	namibast
nezavíral jsem	namibastam
nezavíral jsi	namibasti
nezavírali	namibastand
nezavírali jsme	namibastim
nezavírali jste	namibastid
nezavírám	namibandam
nezavíráme	namibandim
nezavíráš	namibandi
nezavíráte	namibandid
nezavøel	nabast
nezavøel jsem	nabastam
nezavøel jsi	nabasti
nezavøeli	nabastand
nezavøeli jsme	nabastim
nezavøeli jste	nabastid
nezbytnı	lâzem
ne	az
neit	kurak, domal
nic	hic
nicménì	bâ vojude in
nikdy	hargez
nit	nax
níe	pâyine, zire
noc	šab
noha	pâ, sâq
normální	âdi
norskı	norvei
nos	bini, damâq
nosiè zavazadel	bârbar
notes	daftarce
nouzovı vıchod	pelle ye goriz
novinovı stánek	ruznâmeforuši
noviny	ruznâme
novı	now, tâze
Novı rok	Sâl e Now
nula	sefr
nutno	bâyad
nutnı	lâzem
nùky na nehty	qeyci ye nâxon
nylon	nâylon
nyní	hâlâ, aknun
o	darbâre, gerdâgerd, râje'be, darbâreye
ó!	hâ!
oba	har do
obalit	picidan
obálka	pâkat
obèan	šahrund
obèanskı prùkaz	šenâsnâme
obdìlávat	kešt kardan
obdélník	mostatil
období	âvâm
obì	har do
obìd	nâhâr, nahâr
obì	qorbân
obezøetnost	ehtiyât
obchod	maqâze, forušgâh
obilné pole	keštzâr e zorrat
obinadlo	bând e zaxm
objednat	sefâreš dâdan
objednávat	sefâreš dâdan
objevit	kâšef kardan
objevitel	kâšef
objíïka	enherâf
oblek	kot o šalvâr (dast~)
oblièej	cehre, surat
oboèí	abru
obojí	har do
obrazárna	negârestân
obrovskı	mâzandar
obsadit	ešqâl kardan
obtìovat	zahmat dâdan
obtí	došvâri
obvaz	bând e zaxm
ocet	serke
oèní kapky	qatre ye cešm
oèní linky	xatt e cešm
oèní stíny	sâye ye cešm
od	az, xâmuš, kenâr, durtar, jodâ
od té doby‚ co	az hangâmi ke
odcizit	dozdidan
odjezd	harakat
odkazovat	vaqf kardan
odlakovaè	lâkpâkkon
odpoledne	pas az nimruz, ba'd az zohr
odpovìï	pâsox
odpovìdìl	pâsox dâd
odpovìdìl jsem	pâsox dâdam
odpovìdìl jsi	pâsox dâdi
odpovìdìli	pâsox dâdand
odpovìdìli jsme	pâsox dâdim
odpovìdìli jste	pâsox dâdid
odpovìdìt	pâsox dâdan
odpovìdí	pâsox xâhand dâd
odpovìz	pâsox bede
odpoví	pâsox xâhad dâd
odpovídá	javâb midahad
odpovídají	javâb midahand
odpovídal	javâb dâd
odpovídal jsem	javâb dâdam
odpovídal jsi	javâb dâdi
odpovídali	javâb dâdand
odpovídali jsme	javâb dâdim
odpovídali jste	javâb dâdid
odpovídám	javâb midaham
odpovídáme	javâb midahim
odpovídáš	javâb midahi
odpovídat	javâb dâdan
odpovídáte	javâb midahid
odpovídej	javâb bede
odpovím	pâsox xâham dâd
odpovíme	pâsox xâhim dâd
odpovíš	pâsox xâhi dâd
odpovíte	pâsox xâhid dâd
odstín	rang e raqiq
oheò	âtaš
ohnivı	âtašin
okno	panjare, panjere
oko	cešm
okolo	atrâf, gerdâgerd, pirâmun
okoun	mâhi ye xârdâr
okrouhlı	gerd
okurka	xiyâr
okurka (malá	xiyâr e šur
olej	rowqan
olejovı	rowqani
oliva	zeytun
olivovı olej	rowqan e zeytun
omáèka	sos
omastek	corbi
omastit	corb kardan
omdlení	qaš
omdlévat	qaš nemudan
omeleta	omlet
omluva	puzeš
omyl	ârang
on	vey, u
ona	u
ona (pl.)	ânhâ
oni	išân, ânhâ, ânân
oni (pro osoby)	išân
ono	ân
onomu	beân
ony	ânhâ
onyx	aqiq e soleymâni
opálení	âftâbsuxtegi, âftâbsuxtagi
opalovací krém / mléko	kerem e âftâb
opatrnost	ehtiyât
operátor	telefonci
opìt	dobâre
opice	meymun, buzine
oprava	tamir
opravna (dílna)	tamirgâh
oranová	nâranji
orat	kešt kardan
ornitologie	parandešenâsi
osa	mehvar
oslnivá krása	afsungari
osm	hašt
osm set	haštsad
osmdesát	haštâd
osmina	haštom
osmnáct	hejdah
osmı	haštom
osoba	šaxs, fard
osobitı	fardi, šaxsi
osobní	šaxsi, fardi
osobní sluha	pišxedmat
osoby	ašxâs
ostruina	šâhtut
ostrı	tond, tiz
ostuda	šarm
osvìdèení	govâhinâme
otec	pedar
otékat	âmâs kardan
otevøenı	bâz
otok	âmâs
otrava	masmumiyat e qazâyi
ovád	xarmages
ovál	beyzi
ovce	gusfand
ovládat	balad budan
ovoce	mive
ozbrojenı	mosallah, zinâvand
oznámení	tavajjoh
ozvuèení	ostovâr
padat	oftâdan
padesát	panjâh
palác	kâx
palec	šast
Palestina	Felestin, Palestin
palivo	suxt
pamì	yâd
pan	âqâ
Pán	Xodâvand
pán	farmânravâ, šahryâr
pánev	tâbe
paní	xânom
páni	âqâyân
pánové	âqâyân
Panovník	Xodâvand
pantofel	dampâyi
pantofle	joft dampâyi
papír	kâqaz
papírnictví	neveštafzârforuši
papírovı ubrousek	dastmâl e kâqazi
papoušek	tuti
paprsek	partow
pár	joft
párek v rohlíku (housce)	hâtdâg
parfém	atr
park	pârk
parkovat	pârk kardan
parkovištì	pârking
parník	kašti
pasaér	mosâfer
pásek	kamarband
pásek (hod.)	band e sâat
past	dâm
pastelka	qalam, qalam e naqqâši
pastilky proti kašli	qors e sorfe
pastıø	šabân
paštika	pâte
pata	pâšne
pátek	âdine, jom'e
páteø	sotun e faqarât
patnáct	pânzdah
patro	tabaqe
pátı	panjom
pae	bâzu
pedâl (u bicyklu)	rekâb
pedál plynu	pedâl e gâz
pekárna	nânvâyi
pekaøství	nânvâyi
pelerína	šenel
pepø	felfel
pepøit	felfel zadan
perla	morvârid, marvârid
pero	xodkâr, xodnevis, par
pérování	fanar
perskı	fârsi
pes	sag
pìšky	piyâde
pìt	panj
pìt set	pânsad
pìtina	panjom
pevnost	de
pije	miâšâmad
pijeme	miâšâmim
piješ	miâšâmi
pijete	miâšâmid
piji	miâšâmam
pijí	miâšâmand
pil	âšâmid
pil jsem	âšâmidam
pil jsi	âšâmidi
pili	âšâmidand
pili jsme	âšâmidim
pili jste	âšâmidid
pilka	arre
pilníèek na nehty	sombâde ye nâxon
pinzeta	mucin
písmeno	harf
písmo	xatt
píst	piston
pít	âšâmidan
pití	nušidani
pitná voda	âb e âšâmidani
pivo	âbjo, âb e jow
pizza [pica]	pitzâ
pláè	gerye
plachetnice	qâyeq e bâdi
plachta	bâdbân
plán	naqše
plán mìsta	naqše ye šahr
plantá	keštzâr
plastická guma	keš
pláštìnka	bârâni
platina	plâtin
plátno	pârce ye katâni, panbeyi
platıs	mâhi ye pahn
plavá	zard e kamrang
plavat	šenâ kardan
plavky	lâs e šenâ, mâyo
plá	sâhel
plechovka	quti
plemeno	neâd
plenka	kohne ye bacce
plenky	dastmâl e bacce
plíce	šoš
plnı	por, anbâšte, labriz
plod	mive
plot	parcin
pls	namad
pluk	hang
plyn	gâz
po	pas
po (lokál)	ba'adâz
po (podél)	hamrâh, jelow, piš
po (potom)	pas az, dar jostojuye, dar peye
pobøeí	sâhel, kenâr e daryâ
poèátek	ebtedâ
poèítá	mišomorad
poèítají	mišomorand
poèítal	šomord
poèítal jsem	šomordam
poèítal jsi	šomordi
poèítali	šomordand
poèítali jsme	šomordim
poèítali jste	šomordid
poèítám	mišomoram
poèítáme	mišomorim
poèítáš	mišomori
poèítat	šomordan
poèítáte	mišomorid
poèkej	sabr kon
pod	zir, pâyin, pâyine, pâeyn, zire
podivnı	šegeft
podkladovı krém	kerem e zir
podnik	šerkat
podoba	šekl
podpis	emzâ
podšívka	âstar
poduška	nâzbâleš
podzim	pâyiz
pohár	fenjân
pohlednice	kârtpostâl
pohranièí	marzi
pohroma	âfat
pochybnost	šak
pochybovat	šak kardan
pojídal	mixord
pojídal jsem	mixordam
pojídal jsi	mixordi
pojídali	mixordand
pojídali jsme	mixordim
pojídali jste	mixordid
poker [pokr]	poker
poklad	ganj, ganjine, xazâne
poklid	ârâmeš, âsudegi
pokoj	otâq, ârâmeš, âšti, âsâni
pokojská	xedmatkâr
pokrm	qazâ, xorâk
pokroèilı	piš oftâde, piš rafte
pokušení	âzmâyeš, varan, farib, havas
pole	keštzâr
poledne	nimruz, rabih
polévka	šurbâ, âš, âbgušt
police	qafase
policejní stanice	pâsgâh e polis
policie	polis
policista	pâsbân
polièka	qafase
poliklinika	darmângâh
politická strana	hezb
polovièní	nime
polovina	nim
polštáø	bâleš
pomáhat	komak kardan
pomalu	yavâš, âheste
pomalı	âheste, yavâš
pomeranè	nâranj, portaqâl
pomeranèová šáva	kadu ye halvâyi
pomezí	vimand
pomlít	kubidan
pomoc	yâri, komak
pondìlí	došanbe
ponìvad	conke
poníení (adj.)	mostaz'afin
ponoka	jurâb
ponoky	joft jurâb
popelník	jâsigâri
poplatek	hazine
populární hudba	musiqi ye pâp
pór	tare (ye farangi)
porazit	rišekan kardan, darham šekastan
pórek	tare (ye farangi)
porodnice	zâyešgâh
posel	peyk
poschodí	tabaqe
posílat	ferestâdan
poslechnout	guš dâdan
poslíèek	šâgerd, pâdow
poslouchat	guš kardan
postel	taxtexâb, raxtexâb
postihnout	asar kardan
poškodit	ziyân zadan
pošli	beferest
pošta	edâre ye post, postxâne
poštovní úøad	edâre ye post
poštovní vùz	vâgon e bâri
potìšitelnı	xoš
potí	došvâri
potkan	xarmuš
potlaèit	forunešândan, sarkubi kardan
potok	juy, juybâr
potom	pas, sepas
potrava	qazâ
potrubí	lule
potøebnı	lâzem
pouš	sahrâ
pouto	band
pouze	tanhâ, yegâne
pouité zboí	dast e dovom
povaha	maneš
povìdìt	goftan
povídat	goftogu kardan
povídka	afsâne
pozdìji	pas, sepas
pozítøí	pasfardâ
poznání	âšnâyi
poehnání	barekat
poehnanı	xojaste, farxonde, kâmravâ
poehnat	barekat dâdan
prababièka	mâdar-mâdarbozorg
práce	zist, kâr
pracovat	kâr kardan
pracovní	zist
pracovní den	ruz e kâr
pradìdeèek	pedar-pedarbozorg
prádelna	raxtšuyxâne
pramen	cešme
prášek na spaní	qors e xâbâvar
pravda	dorosti, râsti
pravit	goftan
právo	haqq
pravı	râst
prázdnı	xâli
preferovat	tarjih dâdan
prchající	gorizande, âvâre, sargardân
princ	šâhzâde
pro	barâye, barâye inke, darpey
pro(toe)	con
proè	cerâ
prodat	foruxtan
prodavaèka	forušande
prodávat	foruxtan
prodej	foruš
prodejna	maqâze, forušgâh
prodejna potravin	baqqâl
profese	herfe
program	barnâme
programovat	barnâme neveštan
prohibice	bâzdâri
projímadlo	moshel
prominout	baxšidan, baxšudan, âmorzidan
promiòte	puzeš mixâham, bebaxšid
pronajmout	ejâre kardan
prorok	payâmbar
prosím	lotfan, xâheš mikonam
prosinec	desâmbr
prosit	xâheš nemudan
proslulı	mašhur
prostı	sâde
protìjší	ruberu
proti	darbarâbar, zedde, padyâr
protoe	conke, zirâ
prozatím	hanuz
prsa	pestân, sine
prst	angošt
prst u nohy	angošt e pâ
prsten	halqe, angoštar
pršet	bârân âmadan
prudkı	tond
prùhlednı	šaffâf
prùjem	eshâl
prùjezd	gozar
prùkaz	govâhinâme
prùklepovı papír	meqdâr kârbon
prùliv	kânâl
prùplav	âbrâh
prùsvitnı	šaffâf
pruení	fanar
pruina	fanar
první	naxost, avval
První jarní den	Nowruz
první tøída	daraje ye yek
pryè	dur, jodâ, kenâr, xâmuš, durtar
pøát	ârezu kardan
pøátelství	dusti
pøebrat	radif kardan
pøed	piš az, piš
pøed (s akuzativem)	jelow
pøedbìná opatøení	moqaddamât
pøedèasnì	nâbehangâm
pøedèasnı	nâbehangâm
pøedem	piš az
pøedkládat	taqdim dâštan
pøedkrm	pišpâre, pišqazâ
pøedmluva	dibâce
pøedpis	âyinnâme
pøedpovìï	pišbini
pøedprodej	pišforuš
pøedstavitel	namâyande
pøedškolní	pišdabestâni
pøedváleènı	piš az jang
pøedvést	nešân dâdan
pøedvídat	pišbini kardan
pøeháòka	ragbâr
pøehoz	šenel
pøeklad	tarjome
pøekládat	tarjome kardan
pøeloit	tarjome kardan
pøemáhat	cire šodan
pøemoci	piruz šodan
pøemıšlet	fekr kardan
pøepis	pacin
pøeplnìnı	labriz
pøepoèítávat	dobâre šomordan
pøes	sartâsar, azmiyân, abar, ruyi
pøesto	harcand
pøestoe	agarce
pøesvìdèení	imân
pøevodovka	ja'be dande
pøezka	sagak e kamarband
pøezkoušet	âzmâyeš kardan
pøezout se	kafš dar âvardan
pøezouvat se	dar âvardan kafš
pøezùvky	gâleš
pøi	bedaste, nazdik, darpahluye, dar kenâr, dame
pøibíjet	mix kardan
pøibít	kubidan
pøiblíit	nazdik šodan
pøiblinì	nazdik be
pøíèka	narde
pøídavné jméno	sefat
pøihrávat	ferestâdan, pâs dâdan
pøihrávka	pâs
pøicházejí	miâyand
pøicházel	miâmad
pøicházel jsem	miâmadam
pøicházel jsi	miâmadi
pøicházeli	miâmadand
pøicházeli jsme	miâmadim
pøicházeli jste	miâmadid
pøicházet	âmadan
pøichází	miâyad
pøicházím	miâyam
pøicházíme	miâyim
pøicházíš	miâyi
pøicházíte	miâyid
pøíchod	vorud
pøijatı uchazeè	gomârde
pøijde	xâhad âmad
pøijdeme	xâhim âmad
pøijdeš	xâhi âmad
pøijdete	xâhid âmad
pøijdou	xâhand âmad
pøijdu	xâham âmad
pøíjemnı	xoš
pøíjezd	vorud
pøijít	âmadan
pøíkrm	pišqazâ
pøímka	xatt e râst
pøímı	mostaqim
pøinášejí	miârand
pøinášel	miâvard
pøinášel jsem	miâvardam
pøinášel jsi	miâvardi
pøinášeli	miâvardand
pøinášeli jsme	miâvardim
pøinášeli jste	miâvardid
pøinášet	âvardan
pøináší	miârad
pøináším	miâram
pøinášíme	miârim
pøinášíš	miâri
pøinášíte	miârid
pøinese	xâhad âvard
pøineseme	xâhim âvard
pøineseš	xâhi âvard
pøinesete	xâhid âvard
pøinesl	âvard
pøinesl jsem	âvardam
pøinesl jsi	âvardi
pøinesli	âvardand
pøinesli jsme	âvardim
pøinesli jste	âvardid
pøinesou	xâhand âvard
pøinést	âvardan
pøinesu	xâham âvard
pøíplatek za první tøídu	ezâfe-qeymat e daraje ye yek
pøíslovce	band, sarf, qeyd
pøíslušník	andâm
pøístav	bandar
pøišel	âmad
pøišel jsem	âmadam
pøišel jsi	âmadi
pøišli	âmadand
pøišli jsme	âmadim
pøišli jste	âmadid
pøítel	dust
pøivést	âvardan
pøivézt	âvardan
pøízeò	eltefât, yâri
psát	neveštan
pstruh	mâhi ye qezelâlâ
pšenice	gandom
ptá se	miporsad
ptají se	miporsand
ptal jsem se	porsidam
ptal jsi se	porsidi
ptal se	porsid
ptali jsme se	porsidim
ptali jste se	porsidid
ptali se	porsidand
ptám se	miporsam
ptáme se	miporsim
ptáš se	miporsi
ptát se	porsidan
ptáte se	miporsid
ptej se	bepors
pudr	pudr, gard e surat
pùjde	xâhad raft
pùjdeme	xâhim raft
pùjdeš	xâhi raft
pùjdete	xâhid raft
pùjdou	xâhand raft
pùjdu	xâham raft
pùl	nim
pumpa	pomp
punèochy	jurâb e zanâne (joft~)
pytel	kise
pyamo	piâme
rád	xorsand
radiátor	radiâtor, râdiyâtor
rádio	râdiyo
radnice	šahrdâri
rádo se stalo	xâheš mikonam
ragú	xoreš
rajèe	gowje ye farangi
rajské jablko	gowje ye farangi
raketa	âtašafrâze, râket
raketa (tenisová)	cowgân
rakovina	saratân
rameno	duš, šâne
ráno	sobh
rèení	pand
rebarbora	rivâs
recept	nosxe
redukce	kâheš
rek	pahlavân
reklama	âgahi
réservé	reservâsiyon
restaurace	rasturân
ret	lab
reveò	rivâs
revmatismus	româtism
rezervace	reservâsiyon
rezervovanı	rezerv šode
rezervovat	rezerv kardan
ricinovı olej	rowqan e karcak
rijál	riyâl
robot	âdam e âhani
robustní	nirumand
roèenka	sâlnâme
roènì	sâliyâne
rod	neâd
rodina	xânevâde
roh	šâx
rok	sâl
rostlina	nabât
roura	lule
rovnì	ham
rovnı	mostaqim
rozbíjet	šekastan
rozbít	šekastan
rozdíl	farq
rozdrtit	rišekan kardan, darham šekastan
rozhnìvanı	asabâni
rozhovor	goftogu
rozmìr	andâze
rozprášit	darham šekastan, rišekan kardan
rozumìt	fahmidan
rozzlobenı	xašmgin
rtìnka	mâtik, ru
rubín	yâqut
ruèní práce	kâr e dast
ruèní zavazadlo	asbâb e dast
ruèník	howle
rudı	sorx
ruka	dast
rukáv	âstin
rukavice	dastkeš
Rusko	Rusiyye
rušnı	šoluq
rù	mâtik, ru
rùová	surati, goli
rybárna	mâhiforuši
rybaøení	mâhigiri
rybník	berke
rıè	bil
rychlík	qatâr e tondrow
rychlı	tond, sarih
rıe	berenj
øadicí páka	dande
øeditel	modir
øedkev	torob
øedkvièka	torobce
øeka	rudxâne
øepa	coqandar
øetìz	zanjir
øetìzovı	zanjiri
øezal	bord
øezal jsem	bordam
øezal jsi	bordi
øezali	bordand
øezali jsme	bordim
øezali jste	bordid
øezat	boridan
øezával	mibord
øezával jsem	mibordam
øezával jsi	mibordi
øezávali	mibordand
øezávali jsme	mibordim
øezávali jste	mibordid
øezej	bebor
øeznictví	qassâbi, guštforuši
øe	bebor
øee	mibarad
øeeme	mibarim
øeeš	mibari
øeete	mibarid
øeou	mibarand
øeu	mibaram
øíct	goftan
øidiè	rânande
øidièskı prùkaz	govâhinâme ye rânandegi
øídit (auto)	rânandegi kardan
øíjen	oktobr
øíká	miguyad
øíkají	miguyand
øíkal	goft
øíkal jsem	goftam
øíkal jsi	gofti
øíkali	goftand
øíkali jsme	goftim
øíkali jste	goftid
øíkám	miguyam
øíkáme	migu'im
øíkáš	migu'i
øíkat	goftan
øíkáte	migu'id
øízení	farmân
s	bâ
sad	bâqmive
sádra	gac
safír	yâqut e kabud
sako	kot
sál	sâlon
salám	sosis, kâlbâs
salát	sâlâd
salon	sâlon
salon krásy	sâlon e zibâyi
sám	tanhâ
samet	maxmali
samohláska	bâsedâ
samohláskovı	âvâdâr
samoobsluha	supermârket
sanatorium	âsâyešgâh
sandál	sandal
sandály	joft sandal
Sára	Sârâ
sardel	mâhi ye kuli
sardinka	sârdin
satan	šeytân
satén	pârce ye abrišam e masnui, sâtan
sazba	hazine
saze	dude
sázet	kâštan
sbohem	Xodâ negahdâr
sborník	sâlnâme
sèítání	saršomâri, âmârgiri
se	xod
seï	bešin
sedativum	mosakken
sedìt	nešastan
sedlo	zin
sedm	haft
sedm set	haftsad
sedmdesát	haftâd
sedmina	haftom
sedmnáct	hefdah
sedmı	haftom
sekera	tabar, tiše
sekretáøka	monši
sekunda	sâniye
semiš	jir
sen	xâb
sendviè	sândvic
senná rıma	tab e nowbe, tab e šadid
seriál	pošt e sareham
servis	servis
serant	goruhbân
sestra	xâhar
sestøenice	doxtar-e-xâle, amuzâde, doxtar-e-amme
sešit	daftar e pišnevis
setina	sadom
sever	abâxtar, šomâl
severní	abâxtari
seznámení (se)	âšnâyi
sezóna	fasl
shodnı	yeksân
si	xod
síla	niru, tavân
silnice	jâdde
sí	tur
síto	alak
sjednocovat	yeki šodan
sjednotit	yeki kardan, beham peyvastan
skicák	kâqaz e pišnevis
sklenice	livân
sklenka	livân
sklizeò	xarman
sklo	šiše
sklon	šib
skonat	mordan
skoøice	dârcin
skript	xatt
skrıvat	penhân šodan
skrz	azmiyân, sartâsar
skøíò	eškâf, ganje
skøivan	cakâvak
skvost	gowhar
slabikáø	ketâb e alefbâyi
slabı	nazâr, kamzur, nâtavân
sladké	širini
sladkost	širini
sláma	kâh
slanı	namakdâr, šur
sláva	far, šokuh, farrah
sleèna	dušize
sleï	mârmâhi, šâhmâhi
slepı	kur
slib	va'de
slíva	gowje
slon	fil
slova	loqât
slovník	farhang
slovo	laqat, vâe, kaleme
sloka	puše
sluka lesní	xorus e jangali
slunce	xor, xoršid, âftâb
sluneèník	sâyebân
slušnı	šarif
sluba	servis
slyš	bešno
slyšel	šenid
slyšel jsem	šenidam
slyšel jsi	šenidi
slyšeli	šenidand
slyšeli jsme	šenidim
slyšeli jste	šenidid
slyšet	šenidan
slyší	mišenavad
slyší (pl.)	mišenavand
slyším	mišenavam
slyšíme	mišenavim
slyšíš	mišenavi
slyšíte	mišenavid
slza	âšk
smalt	minâkâri
smaragd	zomorrodin, zomorrod
smát se	xandidan
smìnárna	sarrâfi
smìrem k	be, dar râhe, darbâreye, besuye
smést	jârub kardan
smeták	jârub
smetana	xâme
smíšené zboí (prodejna)	xârobârforuši
smrk	šâhdaraxt
smrt	marg
smrtelnı	margbâr
smutek	qam, anduh
snad	šâyad
snadno	be âsâni
snadnı	sâde
snait se	kušidan
snìdl	xorde'ast
snìdl jsem	xorde'am
snìdl jsi	xorde'i
snìdli	xorde'and
snìdli jsme	xorde'im
snìdli jste	xorde'id
snìit	barf âmadan
snídanì	sobhâne
sníh	barf
sníení	kâheš
snoubenec	nâmzed
snubní prsten	halqe ye nâmzedi
sobota	šanbe
sochaøství	tandissâzi
sója	soyâ
sojka	zâqkabud
solenı	namakdâr, namaki
soud	dâdgâh, qazâvat
soudce	qâzi
souhláska	harf e bisedâ
soukolí	dande
souloit	gâyidan
souloit (vulg.)	gâyidan
soumrak	târik e rowšan
soupeø	harif
spací pytel	kise ye xâb
spal	xâbid
spal jsem	xâbidam
spal jsi	xâbidi
spálení (slun.)	âftâbsuxtagi
spali	xâbidand
spali jsme	xâbidim
spali jste	xâbidid
spalnièky	sorxak
spása	rastegâri
spát	xâbidan
spatøovat	negaristan
spával	mixâbid
spával jsem	mixâbidam
spával jsi	mixâbidi
spávali	mixâbidand
spávali jsme	mixâbidim
spávali jste	mixâbidid
spìch	šetâb
spi	bexâb
spí	mixâbad
spí (pl.)	mixâband
spím	mixâbam
spíme	mixâbim
spirála	mârpic
spiritualita	minuyi
spíš	mixâbi
spíte	mixâbid
splést se	eštebâh namudan
splnìní	rasâyi, âzgâr, pâyân
spojit	beham peyvastan
spojka	kelâ, klâc
spoleènì	bâham
spoleènost (obchodní)	šerkat
spolkovı	federâl
spolu	bâham
spona	sagak e kamarband
sponka	cangzan
sponzor	esponsor
sport	varzeš
správce	modir
spravedlivı	âdel
spravedlnost	adl, edâlat
spropitné	en'âm
spøádat	bâftan
Srbsko	Serbestân
srdce	del, qalb
srp	dâs
srpen	ut
stadion	varzešgâh
stal jsem se	šodam
stal jsi se	šodi
stal se	šod
stali jsme se	šodim
stali jste se	šodid
stali se	šodand
stan	câdor
stanice	istgâh
stanovištì	tavaqqofgâh
startování	estârt
starı	pir
stát se	šodan
stativ	sepâye
statnı	nirumand
statut	asâsnâme
stává se	mišavad
stávají se	mišavand
stávám se	mišavam
stáváme se	mišavim
stáváš se	mišavi
stávat se	šodan
stáváte se	mišavid
steak [stejk]	esteyk
stéblo	kâh
stehno	rân
stìhovat se	asbâb kešidan
stejnì	mešâbe, yeksân
stejnı	yeksân, mešâbe
stìna	divâr
sténat	nâle kardan
stìraè	barfpâkkon
stereofonní	esteriyo
sterilizovat	esterlize kardan
sterilní	bibâr
stezka	râh, piyâderow
stín	sâye
stínit	sâye andâxtan
stinnı	sâyedâr
stírat	pâk kardan
stmívat se	târik šodan
sto	sad
stoèit	lule kardan
stodola	anbâr
stojan	pâye
století	qarn
stonek	sâq
stop	ist
stopa	pâ
stoár	dagal
strach	tars
stráò	šib
stranickı	hezbi
strava	qazâ
stráník	pâsbân
strohı	tond
stroj	dastgâh
strojenı	sâxtegi
strojvedoucí	mobâšer e qatâr
strojvùdce	mobâšer e qatâr
strom	deraxt
struènı	kutâh, moxtasar
struna	zeh
strıc	dâyi, ammu
strıc z matèiny strany	dâyi
strıc z otcovy strany	ammu
støed	miyâne
støed mìsta	markaz e šahr
støeda	cahâršanbe
støecha	bâm
støelnı prach	bârut
støevo	rude
støíbro	noqre
støíkat	pâšidan
student	dânešju
studenı	sard
stuha	rubân, navâr
stùl	miz
stuka	navâr
sud	boške
suchı	xošg
suknì	dâman
sùl	namak
sultán	soltân
sup	karkas
supermarket	supermârket
surfovací [serfovací] prkno	mowjšekan
sval	azole
svatı	pâkdâman, pâk, moqaddas, avie
svazek	jeld
svéráznı	vie
svìt	jahân, donyâ
svìtec	pâkdâman, ašu, parhizkâr
svìtlá	rowšan
svìtlo	nur
svìtlı	rowšani
svìtovı	jahâni
svìtoznámı	mašhur
svìtskı	jahâni, donyavi
svíce	šam'
svícen	šam'dân
svíèka	šam'
svíèková	gušt e râste
svoboda	âzâdi
svobodnı	âzâd
svrchník	saršane
syn	farzand, pesar
Syn Boí	Farzand e Xodâ
syn strıce z matèiny strany	pesar-e-dâyi
syn strıce z otcovy strany	pesar-e-ammu
syn tety z matèiny strany	pesar-e-xâle
syn tety z otcovy strany	pesar-e-amme
synagoga	parastešgâh e yahudiyân, kanise
syntéza	tarkib
sypat	pâšidan
sır	panir
syrovı	xâm
sysel	sanjâb
systém	sistem
systematickı	bar yek raveš
š (hláska)	š (horuf)
šablona	negâre
šachmat	mât
šachta	câl
šachy	šatranj
šál	šâl
šála	šâl, šâl e gardan
šálek	fenjân
šampaòské	šâmpâyn
šampion	pahlavân
šampon	šâmpu
šanson	sorud
šare	hazine
šat	lebâs
šátek	rusari
šatnáøka	lebâsdâr
šatník	ganje, eškâf
šaty	lebâs, lebâshâ
šavle	šamšir
šedesát	šast
šedı	xâkestari
šek	cek
šel	raft
šel jsem	raftam
šel jsi	rafti
šeøík	yâs
šest	šeš
šest set	šešsad
šestina	šešom
šestnáct	šânzdah
šestı	šešom
šibenice	dâr
šifon	pârce ye harir e nâzok
šíje	gardan
šikovnı	mâhar
šílenı	divâne
šílet	divâne šodan
šilink	šiling
šíp	tir
šipka	nize
širokı	gošâd
šít	duxtan
šitı	duxte
škaredı	zešt
škoda	ziyân
škola	âmuzešgâh, madrese, dabestân
škrob	nešâste
šlehaèka	xâme ye zade
šli	raftand
šli jsme	raftim
šli jste	raftid
šortky	šort
šowhar	manel
špatnı	bad
špendlík	sanjâq
šperkovnice	gowhardân
špína	cerk
špinavı	cerk
šroub	pic
štìrk	šen
štika	ordakmâhi
štír	kadom
šovík	toršak
šunka	âmbon
švagr	barâdar-e-zan, barâdar-e-šowhar
švagr (bratr mue)	barâdar-e-šowhar
švagr (bratr eny)	barâdar-e-zan
švagrová	xâhar-e-šowhar, xâhar-e-zan
švagrová (sestra mue)	xâhar-e-šowhar
švagrová (sestra eny)	xâhar-e-zan
švestka	âlu
ta	ân
tabák (prodejna)	tambâkuforuši
tady	injâ
tahle	in
tachometr	kilometr-šomâr
tajemství	râz
tak	conin, candân
také	ham, niz
takovı	cenin
talíø	bošqâb
tam	ânjâ
tamhle	ânjâ
tamta	ân
tamten	ân
tamto	ân
taška	kif
táta	bâbâ
tato	in
taxa	hazine
taxi	tâksi
taxikáø	rânande ye tâksi
tì	torâ
tebe	torâ
teï	aknun, hâlâ
Teherán	Tehrân
technologickı	teknoloiki
tele	gusâle
telecí (maso)	gušt e gusâle
telefon	telefon
telefonovat	telefon kardan
televize	televizion, televiziyon
televizor	televiziyon
tìlovı pudr	kerempudr
temnı	târik
ten	ân
tenhle	ân su, in
tenis	tenis
tenisky	kafš e katâni (joft~), kafš e tenis
tento	in
tentı	mesl in
teologie	xodâšenâsi
teplo	garmâ
teplomìr	damâsanj
teplı	garm
tepna	šâhrag
terasa	terâs
termostat	termostât
terylén	terlin
tìšit se	lezzat bordan
teta	amme‚ xâle
teta z matèiny strany	xâle
teta z otcovy strany	amme
text	motun
tìkı	sangin, moškel, saxt
tchán	pedarzan‚ pedaršowhar, pedar-e-zan‚ pedar-e-šowhar
tchán (otec mue)	pedaršowhar, pedar-e-šowhar
tchán (otec eny)	pedarzan, pedar-e-zan
tchynì	mâdar-e-zan‚ mâdar-e-šowhar, mâdarzan‚ mâdaršowhar
tchynì (matka mue)	mâdaršowhar, mâdar-e-šowhar
tchynì (matka eny)	mâdar-e-zan, mâdarzan
ti	beto
ticho	ârâm
tílko	ile
tisíc	hezâr
tisknout	câp kardan
tkadlena	bâfandeh
tkanina	bâft
tkát	bâftan
tleskat	âfarin goftan, kaf zadan
tloustnout	câq šodan
tlumoèit	tafsir kardan
tmavá	tirerang
tmavı	tire, târik
to	ân
to / je / ho (akuzativ)	ânrâ
toaleta	tuâlet, ârâyeš
toaletní taška / kabelka	ja'be ye abzârhâ ye ârâyeš
toastovaè [toustovaè]	tostkon
tobì	beto
tohle	in
tomu	beân
topas	yâqut e zard
topaz	yâqut e zard
topení	harârat
topit	garm kardan
toto	in
továrna	kârxâne
továrník	kârxânedâr
trafika	tambâkuforuši
tramvaj	terâmvâ
transformátor	trânsformâtor
transkripce	pacin
trávit (èas)	gozaštan
trenér	rahbar e varzeši
trh	bâzâr
trhlina	šekâf
tribuna	jâyegâh
trochu	kami
trpìlivost	sabr
trubka	šipor
trùn	taxt
trvalá ondulace	fer
trvání	asrâr
tryskové letadlo	havâpeymâ ye jet
trnice	bâzârce
tøešeò	gilâs
tøetí	sevom
tøetina	som
tøi	se
tøi sta	sisad
tøicet	si
tøikrát	se bâr
tøináct	sizdah
tuba	lule
tucet	dojin
tuènı	carb, câq
tulipán	lâle
tuòák	ton
turbína	turbin
turista	turist
tuka	medâd
tvar	šekl
tváø	cehre, gune, surat
tvíd	tuid
tvoøit	âfaridan
tvrdı	saxt
tvrz	de
tvùj	e to, -at
ty	to
tıden	hafte
tygr	babr
tykev	kadu ye mosammâyi
tyrkys	firuze
u	bedaste, nazdik, dar kenâr, dame, darpahlu
ubrousek	dastmâl e sofre
uctívat	parasteš kardan
uèebnice	âmuzešnâme
úèet	hesâb
uèit se	âmuxtan
uèitel	âmuzgâr
udatnost	arvandi
udìlal	karde'ast
udìlal jsem	karde'am
udìlal jsi	karde'i
udìlali	karde'and
udìlali jsme	karde'im
udìlali jste	karde'id
údolí	darreh, darre
udret	negâh dâštan
uhel	zoqâl
uhelnı	zoqâl
úhlednı	ârâste
uhlí	zoqâl
uhlík	kârbon
ucho	guš
ukrást	dozdidan
úl	kandu
ulice	barzan, xyâbân
ulièka	kuceh
ultrafialovı	arqavâni
umìlec	honarmand
umìlı	sâxtegi, masnu'i
umìní	honar
umìt	balad budan, dânestan
umírá	mimirad
umírají	mimirand
umírám	mimiram
umíráme	mimirim
umíráš	mimiri
umíráte	mimirid
umoòovat	momken kardan
umıvat	šostan
únava	xastegi ye farâvân
univerzita	dânešgâh
únor	fevrie
úpal	âftâbzadagi
upozornìní	extâr, tavajjoh
upozornit	barhazar kardan
úpravnı	ârâste
upøednostòovat	tarjih dâdan
upøímnı	râstnamâ, pâk
upustit od	xod dâri kardan
úøad	edâre
úschovna zavazadel	ambâr e asbâbhâ ye mosâferin
ústa	dahân
ústní voda	dahânšuy
ústøední topení	dastgâh e harârat markazi
ušní kapky	qatre ye guš
úterı	sešanbe
útes	partgâh
utkání	mosâbeqe
utopit	qarq kardan
utopit se	qarq šodan
úvaha	fekr
úvìrová karta	kârt e e'tebâr
uvìøit	bâvar namudan
uvidí	xâhad did
uvidí (pl.)	xâhand did
uvidím	xâham did
uvidíme	xâhim did
uvidíš	xâhi did
uvidíte	xâhid did
úvod	dibâce
uzel	gere
uzenáè	mâhi ye dudi
uzenka	sosis
uzenı sleï	mâhi ye dudi
úzkı	tang
úasnı	bâšokuhi
úeh	âftâbzadagi
v	dar
v prùbìhu	hangâm
vagon	vâgon
váha	vazn, tarâzu
válèit	jangidan
válec (aut.)	silandr
váleèné námoønictvo	niru ye daryâyi
válka	jang
vám	bešomâ
Vánoce	Eyd e Milâd e Masih
vápno	âhak
varování	extâr
varovat	barhazar kardan
vás	šomârâ
váš	e šomâ, -etan
vázanka	krâvât, dastmâl e gardan
vazelína	vâzeline
váná hudba	musiqi ye klâsik
vèera	diruz
vèera veèer	dišab
vèetnì	šâmele
vdìènı	motašakker
vìc	ciz
veèer	šab
veèerní šaty	lebâs e šab
veèeøe	šâm
veèírek	mehmâni, pârti
vìènost	zamân e bikarâne, bikarâni, abadiyat
vìènı	bipâyân, jâvdâni, abadi
vìda	dâneš
vìdec	dânešmand
vìdìl	dânest
vìdìl jsem	dânestam
vìdìl jsi	dânesti
vìdìli	dânestand
vìdìli jsme	dânestim
vìdìli jste	dânestid
vìdìt	dânestan
vìdí	midânand
vedle	nazdik, pahlu, dar kenâr
vedoucí	modir
vedro	garmâ
vìdy	olum
vejce	toxm
vejít	andarun šodan
vìk	senn
velbloud	šotor
velice	besyâr, xeyli
velikost	andâze
velikı	bozorg
velkomìsto	šahr
velkı	bozorg
velmi	xeyli, besyâr
ven	birun
ventil	ventil
vepøedu	darjelow
vepøové (maso)	gušt e xuk
vìøit	gomân kardan, bâvar kardan
ves	deh
veslaøskı èlun	qâyeq e pâru zani
vesnice	dehkâde
vést	rahbari kardan
vesta	ile
vìta	jomleh
vìtev	šâxe
vìtší	bozorgtar
vì	borj
vchod	dar e vorud
ví	midânad
více	bištar
vidìl	did
vidìl jsem	didam
vidìl jsi	didi
vidìli	didand
vidìli jsme	didim
vidìli jste	didid
vidìt	didan
vidí	mibinad
vidí (pl.)	mibinand
vidím	mibinam
vidíme	mibinim
vidíš	mibini
vidíte	mibinid
vidlièka	cangâl
víkend	pâyân e hafte
víla	pari
vím	midânam
víme	midânim
vinice	tâkestân
vinohrad	tâkestân
víra	gomân, imân, bâvar
visaèka	barcasb
víš	midâni
víte	midânid
vítejte	xoš âmadid
vítr	bâd
vlajka	parcam
vlak	qatâr
vlakové nádraí	istgâh e râh e âhan
vlakové spojení	qatâr e ettesâli
vlakovı jízdní øád	barnâme ye harakat e qatârhâ
vlas	mu
vlast	vatan
vlastnictví	mâlekiyat
vlašskı oøech	gerdu
vlanı	velarm
vlk	gorg
vlna	pašm
vloni	pârsâl
vnì	birun
voda	âb
voda po holení	losiyon e pas az riš tarâši
vodopád	âbšâr
vodotrysk	favâre
voják	sarbâz
vojsko	arteš, sepâh, lašgar
volnost	âzâdi
volnı	xâli, âzâd
voòavka	atr
vosa	zanbur
vousy	riš
vpøed	jelow
vpøedu	darjelow
vrak	lâše
vrada	âdamkoši
vrba	bid
vrtulník	helikopter
vøed	domal, kurak
vøed (alud.)	zaxm e šekam
vøelı	garm
vstoupit	andarun šodan
vstup	andarun, dar e vorud
vstupenka	belit
vstupenka na nástupištì	belit e saku
vstupní dveøe	dar e vorud
vše	tamâm, hame, yeksare
všechno	hame ciz, hame, hamegi
vteøina	sâniye
vùdce	rahbar
vùle	erâde, erâdat, ârzu
vùnì	bu
vuøt	sosis
vùz	vâgon
vy	šomâ
vıbornı	âli
vyèerpanost	xastegi ye farâvân
vıdejna jízdenek	bâje ye foruš e belit
vydírání	bâj
vydírat	bâj gereftan
vyhláška	tavajjoh
vıhoda	sud, estefâde, bahrevari
vıhodnost	bahrevari
vyhrát	barande šodan
vyhrazenı	rezerv šode
vıchod	xorâsân, xoruj, xâvar
vıchod (dveøe)	dar e xoruj
vıchodní	xorâsân
vychutnávat	lezzat bordan
vyjádøení akuzativu	râ
vyjádøení dativu	be
vyjádøení genitivu	e
vıjezd	xoruj
vıjezdní	xoruj
vıkladní skøíò	vitrin e maqâze
vıkres	kâqaz e naqqâši
vylekanı	tarside
vylekat	tarsândan
vylézt	birun xazidan
vıloha	vitrin e maqâze
vymyšlenı	sâxtegi
vıòatek	xolâse
vyndat	dar âvardan
vyndávat	dar âvardan
vynikající	âli
vypálit	âtaš zadan
vıpary	bexârât
vypìstovat	kâštan
vypínat	xâmuš kardan
vypláchnout	bâ'âb šostan
vyplòovat	por kardan
vypnout	xâmuš kardan
vypravovat	goftan
vyprodáno	forušrafte
vırobek	sâxte
vıroèí	sâlgard
vırok	azhâr
vıslovnost	talaffoz
vyslovovat	adâ kardan
vysoká škola	dânešgâh
vysokı	boland
vysoušeè vlasù	muxoškkon
vyspìlost	mehtari, bornâyi
vıstava	namâyešgâh
vıstraha	extâr
vystrašenı	tarside
vıtah	âsânsor
vytápìní	harârat
vıvar	âbgušt
vyvolat	birun kašidan, farâxândan
vyzkoušet	emtehân kardan
vyznání	mezhab
vzadu	dirtar az, pošte sar
vzduch	havâ
vzít si	gereftan, bordan
vdy	hamiše
WC	tuâlet
z	xâmuš, jodâ, az, durtar
z druhé ruky (second hand)	dast e dovom
za	barâye inke, pošte sar, darpey, pošt, dirtar az
za (trvání)	hangâm
zabalit	picidan
zábava	sargami
záblesk	nur e kam
zaèátek	ebtedâ
zaèínat	âqâz kardan
zaèít	âqâz namudan
záï (místo vzadu)	nešimangâh
záda	pošt
zahrada	bâq
zahrádka	baqce
zahradní	bâqi
záchod	tuâlet
zachovávat	negâh dâštan
záchrana	nejât
zajíc	xarguš e sahrâyi
zákaz	bâzdâri
zákaz zastavení	tavaqqof mamnu
zakázanı	mamnu
zákaznictvo	gomrok
zákon	qânun
zákusek	keyk
záliv	xalij
zámek	kâx
zamilovanı	kerešme
zánìt	eltehâb
zánìt kloubù	bâd e mafâsel
západ	bâxtar
zápach	bu ye bad
zápal	eltehâb
zápal plic	sinepahlu
zapalovaè	fandak
zapalování	girboks
zápas	mosâbeqe
zápìstí	moc
zápisník	daftarce
Zarathuštra	Zartošt
záøí	septâmbr
zasáhnout	asar kardan
zásobit palivem	suxtgiri kardan
zastav	negâh dâr
zástava	parcam
zastavení	tavaqqof
zastávka	ist
zastavovat	negâh dâštan
zásyp (kosmetickı)	kerempudr
zatím	hanuz
zatmìní slunce	âftâbgereftegi
zavazadlo	jâmedân, asbâb, bâr e safar
zavírá	mibandad
zavírají	mibandand
zavíral	mibast
zavíral jsem	minbastam, mibastam
zavíral jsi	minbasti, mibasti
zavírali	mibastand
zavírali jsme	mibastim
zavírali jste	mibastid
zavírám	mibandam
zavíráme	mibandim
zavíráš	mibandi
zavírat	bastan
zavíráte	mibandid
zavøel	bast
zavøel jsem	bastam
zavøel jsi	basti
zavøeli	bastand
zavøeli jsme	bastim
zavøeli jste	bastid
zavøenı	baste
záeh	barfak, girboks
zaívací potíe	badgovâreši
zbít	zadan
zboòovat	parastidan
zbytek	bâqi
zdát se	xâb didan, namudan, nemudan
zde	injâ
zdráhat se	bad dânestan
zdraví	hâl
zdravotní støedisko	darmângâh
zdrhovadlo	zip
zdret se	xod dâri kardan
zdvi	âsânsor
zelené fazole	lubiyâ ye sabz
zelenina	sabzi
zelenı	sabz
zelí	kalampic
zemì	zamin
zemì‚ stát	kešvar
zemìpis	joqrâfiyâ
zemìtøesení	zaminlarze
zemøel	mord
zemøel jsem	mordam
zemøel jsi	mordi
zemøeli	mordand
zemøeli jsme	mordim
zemøeli jste	mordid
zemøít	mordan
zesilovaè	bolandgu
ze	dâmâd
zima	zemestân
zinek	ruy
zip	zip
zisk	fâyede
zítra	fardâ
zkouška	âzmâyeš
zkrachovalı	varšekaste
zkrotit	sarkubi kardan, forunešândan
zkusit	âzmudan
zlatá	zarrin
zlato	zar
zlepšit	behtar nemudan
zlodìj	dozd
zlomit	šekastan
zlost	xašm
zlı	šarir, šum, ziyânâvar, bad
zmrzlina	bastani
znak	alâmat
znalec	kârdân
znalost	dâneš
znamení	nešâne
znaménko	alâmat
známka	tambr e post
znát	dânestan, šenâxtan
znával	midânest
znával jsem	midânestam
znával jsi	midânesti
znávali	midânestand
znávali jsme	midânestim
znávali jste	midânestid
znovu	bâz, dobâre
zoo	dadânbâq, bâq e vahš
zoologická zahrada	bâq e vahš, dadânbâq
zoologie	jânvaršenâsi
Zoroaster	Zartošt
zpìv	sorud
zpívat	sarâyidan, xândan, âvâz xândan
zpod	azzir, zirin
zpodìní	taxir
zranit	âsib rasândan
zrní	dâne
zrno	dâne
ztrácet	gom kardan
zub	dandân
zubaø	dandânpezešk
zubní kartáèek	dandânšuy
zubní lékaø	dandânpezešk
zubní pasta	xamir e dandân
zùstat	mânidan
zváit	vazn kardan
zvítìzit	barande šodan
zvláštní	vie, sâxtegi
zvon	zang
zvonek	zangole
zvonit	zang zadan
zvrhlı	fâsad
zvuènı	sedâdâr
zvuk	sedâ
zvukovı	âvâdâr
zvyk	âdab
 (hláska)	 (horuf)
ádnı	hic
ák	dânešâmuz
ákovskı	dânešâmuzi
ákynì	šâgard
aloba	šekâyat
ár	tâbeš
árovka	lâmp
e	ke
ebro	dande
ehlièka	otu
ehnat	barekat dâdan, yaštan, bâlestan
elatina	elâtin
elezáøství	âhanforuši
elezitı	âhani
eleznièní stanice	istgâh e râh e âhan
eleznı	âhani
elezo	âhan
ena	zan
enskı	zanâne
enství	zanânegi
id	yahudi
idle	sandali
íla	siyâhrag
iletka	xodtarâš, tiq
ínka	espanj
irafa	zarrafe
ít	zistan
ivot	jân, zendegi, hayât
ivı	zende
íznivı	tešne
láza	qodde
luè	zahre, zardâb
lutohnìdá	zard e kamrang
lutı	zard
olík	oker
upan	kot e xânegi

All rights reserved. © 2002 Libor Sztemon, Havíøov
E-mail: liborsen@quick.cz; http://www.sweb.cz/ls78/libor.htm