abadi	vìènı
abo	kabát, pláš
abr	mrak
abrešim	hedvábí
abru	oboèí
adabiyot	literatura
adad	èíslo, èíslice
adadi butun	celé èíslo
adadi juft	sudé èíslo
adadi toq	liché èíslo
adolat	spravedlnost, právo
afkandan	vrhnout, hodit, odpálit
afkor	názor, mínìní, úsudek
afruxtan	zapálit
afsar	voják
afsus	bohuel, naneštìstí
afšondan	tøást, otøásat, tøepat
afšurdan	vymaèkat
aft	tlama, huba
aftida	padlı, spadlı
aftidan	padat, spadnout
aftiš	pád, dopad
afvi	amnestie
afzaliyat	vıhoda
afzaliyatnok	vıhodnı
afzoiš	zvıšení, pøiráka
afzudan	zvıšit, zvìtšit, stoupat
agar	jestli
ahamiyat	vıznam, dùleitost
ahdnoma	dohoda, úmluva
aholi	obyvatelstvo, populace
ajib	divnı, zvláštní
ajina	èarodìjnice
ajoib	divnı, zvláštní, zajímavı
aka	bratr
aknun	teï, nyní
aksar	vìtšina
aksariyat	vìtšina
alaf	tráva
alayhi	proti
albatta	zajisté, ovšem
allakay	ji, u
alohida	oddìlenı
aloka	pouto, svazek
aloma	znamení
alomat	znak, znaèka, znaménko
alomati suol	otazník
alomati xitob	vykøièník
aloqa	pouto, svazek
alyumini	hliník
amak	strıc
amaliyot	èin, jednání, dìj, skutek, akce
amma	teta
ammo	ale, avšak
amniyat	bezpeènost, bezpeèí
amudi	svislı
an'ana	tradice
an'anavi	tradièní
anbuh	hustı, tlustı, silnı
andeša	myšlenka
andešai bad	zlá myšlenka
andešidan	myslet, mínit, pøemıšlet
andoxtan	hodit, vrhat, støílet, støelit
andoz	daò
andoza	stupeò
anduh	smutek, stesk
angišt	uhlí
anglisi	anglickı
angor	prostor, prostranství, plocha, areál
angur	hrozny
angušt	prst
anguštarin	prsten, krouek
aniq	pøesnı
anor	granátové jablko
anvo	materiál
anjom	oblek, vıroba
apa	sestra
apil	lípa
aqalliyat	menšina
aqibgoh	tıl
aql	rozum
arabi	arabskı
argon	argon
armani	arménskı
aroba	auto
arof	oèistec
arra	pila
arrapušt	páteø
artiš	armáda, vojsko
arus	snoubenka
arzan	proso
arzidan	stát, mít cenu
arziši miyona	støední hodnota
arzon	levnı, lacinı
asab	nerv
asalak	cukr
asar	stopa
asav	kobyla
asiri jangi	váleènı zajatec
askari	voják, vojín
asl	základ
aslan	nebo, vskutku, opravdu
asli	prvotní
asorat	zajetí
asosan	hlavnì
asosi	hlavní
asosnok	dostateènı
asp	kùò
asror	tajemství
asrori tabiat	tajemství pøírody
ašk	slza
ašxos	lidé
avlod	potomstvo
avrang	trùn
avval	poèátek, zaèátek
axmak	blbec, pitomec, idiot
ayb	chyba
aybdor	aloba, obaloba
aybdoršuda	obalovanı
aybnoma	vırok, rozsudek
az	z, od
azob	utrpení
azot	dusík
ba	k, do, smìrem k (vyjádøení dativu)
babr	lev
bad	špatnı, zlı
bahil	lakomı, skoupı
bahor	jaro
bahr	moøe
baland šudan	rozmnoovat, zvìtšovat, zvyšovat
bale	ano
balki	ale, avšak
bar	šíøka
barf	sníh
barkašidan	váit, zváit
barobari	rovnost, shoda
baroi	pro, za
baroi èi	proè, naè
baron onki	protoe
barq	blesk, záblesk
barra	jehnì, beránek
barvaqt	záhy, brzy, døíve
bastan	pøipojit, upevnit, svázat, pøišít
baxšidan	prominout, odpustit
baxt	štìstí, blaho
baxtiyor	šastnı
baynulmilal	mezinárodní
be	bez
bed	vrba
begoh	veèer
begunoh	nevinnı
behtar	lepší
bel	rıè
belorusi	bìloruskı
bemor	nemocnı
benamoud	nehezkı, ošklivı
berilli	beryllium
beštar	lépe
beva	vdova
bezan	svobodnı
bini	nos
birinj	rıe
bist	dvacet
bo	s
bobo	dìdeèek
bod	vítr
bodbon	plachta
bofanda	tkadlec
boftan	tkát
bokira	panna
bolqa	kladivo
bom	støecha
boq	zahrada
bor	váha, bor
boridan	pršet
boron	déš
bosniyagi	bosenskı
bozor	trh, bazar
bozsoz	pøestavba
brom	brom
budan	bıt
bum	sova
buqa	bık
bur	køída
burdan	nést, pøinést
buridan	støíhat, ostøíhat
burj	vì
buron	bouøe
busa	polibek
butparasti	pohanství
buvi	babièka
buy	vùnì, pach
buzurg	velkı
èahor	ètyøi
èahorum	ètvrtı
èakalak	les
èaman	louka
èana	sánì
èang	prach
èap	levı
èaridan	pást se
èarm	kùe
èaroq	lampa
èarx	kolo
èašm	oko
èašmak	oko
èatr	deštník
èexi	èeskı
èi	co, kterı, jen
èiz	vìc
èodar	závoj, èádor
èoh	studna
èor	ètyøi
èorum	ètvrtı
èoy	èaj
èujagirak	jestøáb
èukur	hlubokı, dùkladnı
èulok	kulhavı
èun	ale, avšak
èunki	nebo, protoe, ponìvad
èupon	pastıø
èutka	kartáè
daftar	sešit
dah	deset
dahon	ústa
dahum	desátı, desetina
daiman	vdy, stále, poøád
dalel	dùkaz
daqiqa	minuta
dar	v, dveøe
dar osoištagi	v míru
dar zamoni	za (èas.), po dobu, v èase
darav	úroda, eò, sklizeò
daraxt	strom
darbon	vrátnı
darbor	palác
dard	bolest
daroz	dlouhı
dars	lekce
dast	ruka
dasta	dradlo, rukoje
dasti èap	levá ruka
dasti rost	pravá ruka
davlat	stát, zemì
davor zanondan	otoèit, obrátit, zatoèit
deha	vesnice, ves
dehkon	sedlák, venkovan
der	pozdì
dev	netvor, obluda, stvùra, ïábel
devor	zeï, stìna
didan	vidìt
digar	jinı, další
din	náboenství
diqqat	pozor
donistan	vìdìt, znát, umìt
donišjuy	univerzita, vysoká škola
doru	lék
dorusoz	lékárník
doštan	mít
du	dva, dvì
duda	saze
dugona	pøítelkynì
dukon	obchùdek
dungi	koš
dunyo	svìt
dur	dalekı, vzdálenı
duraxšidan	lesknout se, tøpytit se
duraxšon	lesk, tøpyt
duredgar	truhláø
durud	nazdar, ahoj
duruq	le
dust	pøítel
dust doštan	milovat, mít rád
dusti	pøátelství
dušanbe	pondìlí
dušidan	dojit
dušman	nepøítel
duzd	zlodìj
duzdidan	ukrást, odcizit
ehtimol	snad, moná
erdam	pomoc
ey	vyjádøení vokativu
fared	vızva, volání
faromuš	opomenutí
faromuš kardan	opomenout
farošturuk	vlaštovka
farš	pùda, zemì
farzand	dítì, syn
fasl	roèní období, sezona
faxr kardan	chlubit se
fil	slon
fini	finskı
firdavs	ráj
firistodan	poslat, odeslat, zaslat
forsi	perskı
fosfor	fosfor
fransavi	francouzskı
ftor	fluor
furešanada	obchodní, kupec, obchodník
furu burdan	polykat, hltat
furuš	prodej
furušanda	prodavaè
furuxtan	prodávat, prodat
fuak	pijavice
gagauzi	gagauzskı
gahvora	kolébka
gala	smeèka, hejno, stádo
galli	gallium
ganda	zlı, špatnı
gandum	pšenice
ganj	poklad
garavgon	rukojmí
gardan	krk, hrdlo
garm	horkı, teplı, vøelı
garmièa	puchıø
gavazn	jelen
gavmija	jeèné zrno
gazidan	kousnout, uštknout
gazna	kopøiva
gazvor	plátno, obraz
geli	helium
germani	germanium
gidrogen	vodík
gird	kulatı, okrouhlı
gireh	uzel
giristan	plakat, slzet
giyoh	rostlina, bylina
gov	kráva
guftan	øíci, pravit, øíkat
gum kardan	zmaøit, ztratit, zahubit
gumruk	celnice, clo
gung	nìmı
gungišk	vrabec
gunoh	høích
gunoh kardan	zhøešit
gunohkor	høíšnı
gur	hrob
gurda	ledvina
gurg	vlk
gurm	suk
gurusna	hladovı
gurxar	zebra
gusfand	beran
guš	ucho
gušna šudan	mít hlad, hladovìt
gušt	maso
guzoštan	klást, poloit, postavit
ha	ano
hafa	smutnı, truchlivı
haft	sedm
hafta	tıden
haftum	sedmı
hama	všechen, kadı, všichni
hama èiz	všechno, vše
hamla	útok
haqiqat	skuteènost
harf	písmeno
harf zadan	mluvit
harguš	koktavı
harom	neèistı
hašt	osm
havo	vzduch, poèasí
havopaymo	letadlo
hayot	ivot
hayvon	zvíøe, ivoèich
hayz	menstruace
hazor	tisíc
hazorum	tisící
hec kas	nikdo, ádnı
heè èiz	nic
hissiyot	pocity
holandi	holandskı
hujum	útok
hujum kardan	útoèit, udeøit, napadnout, zaútoèit
iblis	ïábel, satan
ibtido	zaèátek, poèátek
idiš	jidiš
iflok	špinavı
imon	víra
imruz	dnes
in	tento, tato, toto
indoneziyagi	indonéskı
intizom	poøádek
injil	evangelium
injo	zde, tady
ioqut	rubín
iroda	vùle
ism	jméno
Iso	Jeíš
ispani	španìlskı
italiyovi	italskı
Iyoloti Muttahida	Spojené státy
iz	stopa
jahidan	skákat, skoèit
jahon	svìt
jalol	sláva
jang	válka
jangidan	válèit
janub	jih
jar	úvoz, rokle, úlabina
jav	oves
javdor	ito
javob	odpovìï
javon	mladı
javoni	mládí
jevon	skøíò
jinsi mardona	muské pohlaví
jinsi zanona	enské pohlaví
jiray šepal gel	hlína, jíl
jiyan	synovec
jodugar	kouzelník, èarodìj
jon	duše
joponi	japonskı
joq	èelist
jorub	koštì, smeták
jovidan	vıkat
juft	pár, dvojice, sudı
jumla	vìta, fráze
kabud	modrı
kabutar	holub
kahrahmon	hrdina
kahva	káva
kalagi	cín
kalamuš	krysa
kali	draslík
kalima	slovo
kalom	slovo
kalpesa	ještìrka
kam	trochu
kambaqal	chudı, ubohı
kamon	oblouk
kandu	úl
kanot	køídlo, peru
kar	hluchı
karbon	uhlík
kas	osoba
kast	msta, pomsta
kašok	chudı, ubohı
kataloni	katalánskı
kay	kdy
kadum	štír
kelin	snacha
ki	kdo
kirgizi	kyrgyzskı
kirm	èerv
kirmin	èervivı
kišlok	vesnice
kišvar	zemì, stát
kitob	kniha
kobalt	kobalt
koh	sláma
koj	jedle
kon	dùl
koqazam	papír
kor	práce
kor kardan	pracovat
koreyagi	korejskı
korgar	dìlník
koridan	sít
kormand	zamìstnanec, pracovník
koštan	zasadit
kripton	krypton
kubidan	mlít
kuèa	mìsto
kudak	dítì
kuh	hora
kuhna	starı
kujo	kde
kul	jezero
kulang	volavka
kuloh	èepice
kunj	úhel
kupruk	most
kur	slepı, nevidomı
kurta	šaty
kušiš	snaha, úsilí, námaha
kušodan	otevøít
kuštan	zabít
kuya	mol
lab	ret
lal	safír
langar	kotva
langidan	kulhat
larg	jilm
larzidan	tøást se, chvìt se
lekin	ale, avšak
liti	lithium
litvagi	litevskı
loy	bláto, bahno
lozim	nutnı, potøebnı, nezbytnı
lubyo	fazole
luè	nahı, holı
luxtak	loutka, panenka
magni	hoøèík
makedoni	makedonskı
makidan	sát, cucat
maktab	škola
maktub	dopis, list
malakut	království
malaziyagi	malajskı
malla	plavovlası
mamot	smrt
man	já
mangan	mangan
mano	smysl, vıznam
manzil	byt
maqz	mozek
mard	mu, manel
mardona	muskı
mardum	lid
marg	smrt
markaz	støed, centrum
marvorid	perla
Maseh	Mesiáš, Kristus
mast	opilı
matematika	matematika
matn	text
mato	tkanina, látka
Matto	Matouš
mavj	vlna
may	víno
maymun	opice
meš	ovce
metin	krumpáè
meva	ovoce
mexi peèdor	šroub
mexnatdust	pracovník
mezak	moè
mezidan	moèit
milal	národ
minatdor	uznalı, vdìènı
minqor	zobák
miranda	smrtelnı
mis	mìï
mîšyak	arzen
miyona	støed, centrum
miz	stùl
mo	my
modar	matka
modyon	kobyla
moh	mìsíc
mohi	ryba
mol	zboí
mor	had
mordaxur	sup
muallim	profesor
muhabbat	láska
muhim	dùleitı
muqaddas	svatı, posvìcenı
murè	pepø
murda	mrtvı, zesnulı
murdagi	mrtvı, zesnulı
murdan	zemøít, skonat, umøít
murud	hruška
musofir	cestovatel, cestující
muš	myš
mušt	pìst
muzd	mzda
nafar	osoba, èlovìk
najot	spása
namak	sùl
namoz	modlitba
namoz xondan	modlit se, prosit
namudan	zdát se, jevit se
narm	mìkkı
narx	cena
nasim	safír
nask	èoèka
natri	sodík
nav	novı
naxud	hrách
naxustvazir	premiér, pøedseda vlády
nay	rákos, tøtina
nayza	kopí, oštìp
nazdik	blízko
neon	neon
nikel’	nikl
nikoh	manelství
nim	pùl, polovina
nisf	polovina
nišasta	poloenı, umístìnı
nišon	znaménko
nišon dodan	ukázat, projevit
ništyak	jeskynì
nok	hruška
nom	jméno
nomdor	zvanı, jmenovanı, øeèenı
nomidan	pojmenovat, jmenovat
non	chléb
norvegi	norskı
noxun	nehet
nuh	devìt
nuhum	devátı
nukra	støíbro
nur	svìtlo
nušidan	pít
nušok	nápoj
ob	voda
odam	èlovìk
odamiyon	lidé
odamon	lidé
oddiy	prostı, jednoduchı
ofaridan	tvoøit, stvoøit
oftob	slunce
oftobparast	sluneènice
ohan	elezo
ohu	laò
oilador	enatı, vdaná
oksigen	kyslík
olaš	buk
olim	vìdec, uèenec
olmoni	nìmeckı
olu	švestka
omad	pøíchod
omadan	pøijít, pøicházet
omextan	míchat, smísit
omin	amen
omuxtan	uèit, vyuèovat
omuzgor	uèitel
on	ten, ta, to, tamten, tamta, tamto
onho	oni, ony, ona, ti, ty, ta
orinj	loket
orom	klidnı, tichı, pokojnı
oromi	ticho, klid
orzu	pøání
osiyob	mlın
osmon	nebe
osoištagi	mír, pokoj
ošiq	láska
ošxona	kuchynì
ošyona	hnízdo
otaš	oheò
ovardan	pøinášet, pøinést
ovexta	povìšenı, obìšenı
ovextan	povìsit, viset, obìsit
ovoz	hlas
ozari	ázerbájdánskı
ozaxm	bradavice
ozmoiš	pokušení
ozmudan	testovat
ozodona	volnost, svoboda
padar	otec
pakana	trpaslík
palang	tygr
panj	pìt
par	pero
paranda	pták
parèam	vlajka, prapor
pardoxtan	platit
paridan	letìt, létat
partoftan	zvracet
paša	moucha
pašm	vlna
paxta	bavlna
peš	pøedek, pøední èást
Petrus	Petr
pezešk	lékaø
pilk	víèko
pir	starı
piramard	staøec
pirduxtar	stará panna
piston	vemeno
piyodagard	chodec, pìší
piyola	šálek, hrnek
piyoz	cibule, pórek
po	noha
pok	vlastní, pøíslušnı
polyaki	polskı
portugali	portugalskı
pukkašak	vıvrtka
pul	most, peníze
pur	plnı
purmasoma	bunìènı, bunièitı
pursidan	ptát se, dotazovat se
pursiš	dotaz, otázka
pust	kùe
pustin	koich
pušok	oblek
pušt	záda, høbet
puxtan	vaøit, péci
qabila	kmen, národ
qabul kardan	pøijmout
qadam	krok
qafas	klec
qarb	západ
qasr	palác
qašqaldoq	jezevec
qeg kas	nikdo
qonun	zákon, právo
qoz	husa
qu	labu
quk	ropucha
qulla	vrch, vrchol
qulom	nevolník
qulomi	nevolnictví, poroba
qurridan	vıt, øvát
quvvat	moc
raftan	jít
rag	íla
rahmat	milost
raksidan	tanèit
ran	stehno, kıta
randa	hoblík
raqam	èíslice
rasida	dospìlı, zralı
rasidagi	dospìlost, zralost
rasidan	dospìt, dozrát
ravqan	máslo
ravšan	svìtelnı
ravšani	svìtlo
raxna	díra
reg	písek
reša	koøen
revoj	rebarbora
rod	øeka
roh	cesta
rohbar	vùdce, prùvodce
rost	pravda, pravı, pravdivı
rosti	pravda
rozak	chmel
rubidi	rubidium
ruboh	liška
ruftan	mést, zametat
ruh	duch, zinek
ruhsora	tváø, líce
rujat	seznam, listina
rumini	rumunskı
rumolèa	kapesník
ruqat	seznam, listina, soupis
rusi	ruskı
ruxsat	prázdniny, dovolená
ruy	oblièej, líc
ruz	den
sabz	zelenı, zeleò
sad	sto
sadbarg	rùe
sado	hlas
sadum	stı
sadum bor	stokrát
sadyak	setina
safar	cestování, jízda, cesta
safed	bílı
safedor	topol
sala	turban
salab	orchidej
salomati	zdraví
sang	kámen
sangpušt	elva
sanovbar	borovice, sosna
sar	hlava
sarkaš	tvrdohlavı, umínìnı
savgang	pøísaha
savsan	lilie
savsor	kuna
savvum	tøetí
sayora	planeta
se	tøi
seb	jablko
selen	selen
ser	nasycenı, sytı
serbi	srbskı
seyum	tøetí
sihr	tajemství
siliciy	køemík
siloh	zbraò
simob	rtu
sin	vìk
sina	hruï, prsa
sinf	tøída
sipar	štít
sipas	potom, pak
sipor	pluh
siposguzor	uznalı, vdìènı
sipurz	slezina
sir	èesnek
sirištan	válet, hníst
sirko	ocet
sitod	štáb
sitora	hvìzda
sitorazor	hvìzdnı
siyoh	èernı, èerò
siyosat	politika
skandi	skandium
slovaki	slovenskı
sloveni	slovinskı
soat	hodinky
sol	rok
sola	rok
solnoma	kalendáø
solonai	roèní, vıroèní
soya	stín
sozanda	hudebník, muzikant
sozgor	zdravı
soziš	soulad, souhlas
sozmon	organizace
Sozmoni Milali Muttaxid	Organizace spojenıch národù
sudmand	vıhodnı
suiqasd	vrada
sulfur	síra
sulola	dynastie
suol	otázka
suporidan	rozkázat, velet, pøikázat, poruèit
suqut	ticho, mlèení
surat	obraz, podoba
surb	olovo
surfa	kašel
surox	díra
surud	zpìv
surudan	zpívat
surx	èervenı, èerveò
sust	pomalı, liknavı
sutun	sloup
suxtor	popálenina
suzan	jehla
suzon	horkı, vøelı, palèivı
ša'n	sláva
šab	noc
šabona	noc
šabparak	noèní mùra
šadid	silnı, mohutnı
šafak	úsvit, svítání
šaffof	prùhlednı, prùsvitnı
šaftolu	broskev
šahodat	svìdectví
šahr	mìsto
šahri buzurg	velkomìsto
šahrvand	obèan
šahrvandi	obèanskı, civilní
šak	pochybnost, nejistota
šakar	cukr
šalvor	kalhoty
šam	svíèka, svíce
šamol	vítr
šamšer	meè
šaraf	sláva
šarayon	tepna
šarbat	šáva, dus
šariki	obyèejnı, obecnı, všední
šarm	hanba, ostuda
šarmgin	nesmìlı, plachı, bázlivı
šarmin	stydlivı, ostıchavı
šarnoma	dohoda, úmluva
šarob	šáva, dus
šarora	jiskra
šarq	vıchod
šart	sázka
šaš	šest
šašum	šestı
šašyak	šestina
šavhar	manel, cho
šavq	zájem
šaxse	èlovìk, bytost
šelon	jídlo, chod
šer	lev
ševa	náøeèí, dialekt
šift	strop
šikam	bøicho
šikanja	muèení, muka
šikast	poráka
šikasta	rozbitı, zlomenı
šikastan	lámat
šikof	díra
šikor	hon, lov
šikorèi	lovec, myslivec
šikoridan	lovit, honit
šimol	sever
šino	plavání
šinondan	posadit, usadit
šinos	známı
šinoxtan	znát
šior	brázda
šir	mléko
širgarm	teplı, horkı
širin	sladkı, lahodnı
širkat	úøad, kanceláø, spoleènost
šistan	poloit, umístit, sedìt
šiša	láhev, sklo
šiyar	brázda
šod	veselı, radostnı
šogird	ák
šoh	král
šohgavazn	los
šona	høeben
šubušk	veš
šudan	stát se
šug	bajka
šuh	veselı, radostnı
šuhratmand	známı
šuhratnok	známı
šujo'	odvánı, stateènı
šujoat	odvaha, stateènost
šukufa	kvìtina, kvìt
šula	plamen
šumo	vy
šumor	jiskra
šumtol	jasan
šumur	poèet, vıèet
šumurdan	poèítat
šung	jasan
šunidan	slyšet
šuo	paprsek
šuql	povolání, zamìstnání
šuravi	svazovı
šurbo	polévka
šuriš	povstání, pozdviení
šuro	rada
šurrut	kapalina, tekutina
šurtan	štika
šustan	mıt, umıvat
šuš	plíce
šutur	velbloud
šuur	vìdomí, svìdomí
šuxrat	sláva
švedi	švédskı
ta'in	setkání
tab	horeèka
tabar	sekera
tabdil	zmìna
tabiat	pøíroda
tadovi	uzdravení, vyléèení
tafsoniš	topení
tagarg	kroupy, krupobití
tahayur	údiv, úas, ohromení
tahlil	rozbor
tajriba	zkušenost
takondan	tøást, tøepat, otøásat
takror	opakování
talab	ádost, prosba
talabidan	pøát si, touit
tamili	tamilskı
taqo	strıc
tarjuman	pøekladatel, tlumoèník
taroš	bøitva
tarošidan	holit
tars	strach, obava
tarsidan	bát se, mít strach, obávat se
tarsonèak	bojácnı, zbabìlı, bázlivı, zbabìlec
tasma	pás, opasek, pásek
tavallud	narození, zrození
tavonistan	moci, smìt
tavr	zpùsob
taxt	trùn
taxta	prkno, lávka
tayi	thajskı
tayloq	tele
tayora	pøipravenı, hotovı
tešuk	díra
tez	ostrı, rychlı, prudkı, rychle, honem
tillo	zlato
tin	støíbro
tir	osa
tiramoh	podzim
tirandoz	støelec
titan	titan
tobiston	léto
torik	tmavı, temnı
tortanak	pavouk
totori	tatarskı
toik	tádickı
tu	ty
tuda	hromada, kupa
tuf	slina
tuhfa	dar
tuman	mlha
tund	hoøkı
turki	tureckı
tus	bøíza
tuxm	vejce
u	on
ukob	orel
ukraini	ukrajinskı
ustuxon	kost
utok	kus
uzbek	uzbeckı
va	a
vagon	vagon, vùz
vakte	kdy
vakte ki	mezitímco
vale	ale, avšak
vanadi	vanad
vaqt	èas
vaqte	kdy
vay	on, ona, ono
vazidan	vanout, foukat
vaznin	tìkı
vengeri	maïarskı
vetnami	vietnamskı
vitrina	vıloha, vitrína
xabar	novinka, zpráva
xam	také, rovnì, té
xamir	pasta
xamsoya	soused, bliní
xanda	smích
xandidan	smát se
xar	osel
xarf	písmo
xargiš	králík
xarob	hubenı
xarorat	teplota
xatarnok	nebezpeèí
xazanda	plaz
xedzvakt	kdy, vùbec nìkdy
xele	velmi
xeš	pøíbuznı
xirad	moudrost
xirs	medvìd
xišt	cihla
xizmat	sluba
xlor	chlor
xob	spánek
xohar	sestra
xohiš	vùle
xok	pùda, zemì
xokistar	popel
xoksor	prach
xomušak	komár
xona	dùm
xondan	èíst
xonum	paní, dáma
xorvati	chorvatskı
xostan	chtít
xrom	chrom
xub	dobrı
Xudo	Bùh
Xudovand	Pán, Hospodin
xuk	vepø, prase
xun	krev
xurok	potrava, strava, pokrm
xuronidan	ivit, krmit
xursandi	radost
xusur	tchán
xušbaxtona	naštìstí, šastnì
xušk	suchı
yagonagi	jednota
yak	jeden, jedna, jedno
yakèand	nìkolik
yakum	první
yaroq	zbraò
yaxdon	lednièka, lednice
yo	nebo
yoftan	nalézt, objevit, shledat
yordam dodan	pomáhat
yordam kardan	pomáhat
yos	šeøík
Yuhanno	Jan
yunoni	øeckı
zabon	jazyk
zabonšinos	jazykovìdec, lingvista
zabonšinosi	lingvistika, jazykovìda
zahr	jed
zamin	zemì
zamiston	zima
zamon	èas, doba
zamoni guzašta	èas minulı
zamoni oyanda	èas budoucí
zanbur	vosa
zandor	enich
zang	rez
zarguš	králík
zaxm	zranìní, rána
zaxmxurda	ranìnı, poranìnı, zranìnı
zebogi	krása
zeboyand	nádhernı
zero	nebo
zinda	ivı, èilı
zindagi	ivot
zindagi kardan	ít
zistan	ít
ziyod	rozmnoení, rozšíøení, zvìtšení
zoqnul	krumpáè
zudzud	èasto